Dalhart: "Dalhart Senior High School | Corral RV Park | Hodie's BBQ | Dust Bowl Bar And Grill | The Flying Pig Mercantile Coffee & Tea Bar"
Texas City: "Terraza | Taqueria El Jaliciense | BayShore Park | Beeler-Manske Clinic | Boyd's Bait Shop"
Pasadena: "Washburn Tunnel | Tepatitlan Bakery | Dollar Tree | Taqueri De Jalisco | Chevron Phillips"
Baytown: "Bakery Outlet | Antonio's Italian Grill & Seafood | Foodtown | Max Bowl | Harbor Freight Tools"
Arlington: "Six Flags Over Texas | AT&T Stadium | Texas Live! | Choctaw Stadium | New York Eats"
New London: "ShopRite | Staples | Ocean Beach Park | New London High School | Mr. G's"
Stamford: "Ridgeway Shopping Center | Chelsea Piers Connecticut | Grade A Market | Java Joe's | Scalzi Park"
Waterbury: "Costco Food Court | Fulton Park | Red White & Blue Thrift Store | Los Garcia Mexican Fusion | Brooklyn Baking Company"
New Bedford: "Walmart | Trucchi's Supermarkets | Buttonwood Park | the Buttonwood Park Zoo | New Bedford Harborwalk"
Springfield: "Baystate Medical Center | Food Zone | MassMutual Center | puerto rico bakery 1 | Smead Arena"
Salem: "Salem Hospital | Salem Common | Salem Dog Park | the Salem Witch Museum | Busa Wine & Spirts"
Pittsfield: "market 32 | Angelina's Subs | Berkshire Athenaeum | Guido's Fresh Marketplace | Ayelada"
Montpelier: "The Wayside Restaurant | Hunger Mountain Coop | Guy's Farm & Yard | Sarducci's | Three Penny Taproom"
Auburn: "Auburn Mall | SkyBar Café | University Station RV Resort | Panda | Moore's Mill Golf Club"
Florence: "St. Florian Park | Church Of The Highlands | Stanfield's River Bottom Grill | Newbern's Catfish House | Blue Door Thrift Store"
Winter Haven: "Plaza Mexico | Peppa Pig Theme Park | Tacos My Friend | Harborside | The Apple Lounge"
Melbourne: "Wickham Park | Slices Pizza | Melbourne Square Mall Food Court | Health First Medical Group Medical Plaza | Eau Gallie HS Auditorium"
Homestead: "La Morenitau | Roscoe Warren Muncipal Park | Bangkok Cuisine | Sedano's | Homestead-Miami Speedway"
Sanford: "West Sanford Goodwill | Sanford Moose Lodge | Airport Hanger Bar | The Preserve At Eagle Lake | China Wok"
Miami Beach: "Miami Beach | South Pointe Park | Lincoln Road Mall | North Beach Oceanside Park | Welcome To Miami Beach Sign"
Coral Springs: "Riverside Park | Cypress Park | Church by the Glades | Cypress Park - Soccer Fields | Macys Men And Home"
Port Charlotte: "Riverwood Golf Club | Portside Tavern | Sweet Scoops | Charlotte County Fair Grounds | Prime Serious Steak"
Spring Hill: "Veterans Memorial Park | Marker 48 Brewing | Richie Cheesesteak | PJ's Brick Oven Pizza | Buffet City"
Palm Coast: "Bj’s | P Section | Snow Mountain | Indian Trails Sports Complex | Jungle Hut Beach"
Palatka: "Ravine Gardens State Park | Crill & Palm Veterinary Hospital | Bradley's | Francis Youth Sports Complex | Putnam Lanes"
Leesburg: "Arlington Ridge Golf Club | Jesse Black Saloon | Oakwood Smokehouse | Ichiban | The Plantation Golf Club - Cranes Roost Course"
Lake City: "La Fiesta Tacos & Tequila | Ellianos on 90 | Cedar River Seafood | Lake City  V A  HOSPITAL | Costa del Sol"
Crestview: "Shoal River Middle School | Split Oaks Saloon | the Crosspoint Church | Walker Elementary | Old Time Antiques"
Panama City: "Majette Dunes Disc Golf Course | Pepper's | Buddy Gandy Seafood Inc | Chow Time | 23rd Street Waffle Shoppe"
Dalton: "Walnut Square Mall | Kelly's Restaurant | The Spiced Apple | Dalton Community Center - Mack Gaston | Pollo Alegre"
Marietta: "Marietta Diner | Marietta Square | The Big Chicken | Marietta Square Market | Fair Oaks Recreation Center"
Waycross: "The Mexican Trailer | Pak's Karate | Okefenokee Fairgrounds | Waycross Health & Rehabillitation | Hog-N-Bones"
La Grange: "Beacon Brewing Co. | Hog Heaven | Charlie Joseph's | Wild Leap Brew Co. | Troup High School"
Southaven: "Baptist Memorial Hospital - DeSoto | Landers Center | Central Park | Sunbeam Bakery Store | Superlo Foods"
Meridian: "Meridian Crossroads | Uptown Meridian | Aldersgate Retirement Community | Books-A-Million | The Daily Grind"
Laurel: "Coca-Cola | Roses | Xtreme Outfitters | Dixie Golf Club | Vic's"
Spartanburg: "Hunan K Restaurant | El limon | Bellews Produce Market | Hamrick's | Pi-Squared Pizza"
Orangeburg: "El San Jose | Orangeburg County School District Administrative Offices | Dukes Bar-B-Que | Howard Middle School | First Southern Methodist Church of Orangeburg"
Galesburg: "Galesburg High School | Orange Cup Side Hustle | ALDI | Cactus Country | Sidetrax Bar & Grill"
Joliet: "Autobahn Country Club | Tony's Finer Foods | Louis Joliet Mall | Cherry Hill Cafe | Presence Saint Joseph Medical Center"
Cape Girardeau: "Starved Rock State Park | the Brookfield Zoo | Millennium Park | United Center | Mitsuwa Marketplace"
Rockford: "BMO Harris Bank Center | Toad Hall Books and Records | Valli Produce | Pinnon | Beef-A-Roo"
Evanston: "Robert Crown Ice Rink | The Supreme Burrito #1 | Lakefront Trail | Dawes Park | Northshore Evanston Woman’s Hospital"
Rock Island: "Wake Brewing | Broadway District of Rock Island | Bent River Brewing Company | Whitey's Ice Cream | Arthur's Garden Deli"
Elgin: "Camp Big Timber - Boy Scout Camp | Butera Market | Burnidge Forest Preserve | Presence Saint Joseph Hospital, Elgin | Country Donuts"
Richmond: "Glen Miller Park | Fricker's | La Mexicana Mini Market LLC | Golden Living Center | Richmond High School"
Terre Haute: "Cheddar's Scratch Kitchen | Twiggy's Pub | Los Tres Caminos | Hawthorne Park | Baesler's Market"
Lafayette: "IU Health Arnett Hospital | Mike Aulby's Arrowhead Bowl | Igloo Frozen Custard | Cheddar's Scratch Kitchen | the John T Myers Pedestrian Bridge"
Marion: "Lucas Oil Stadium | the Indianapolis Zoo | White River State Park | The Children's Museum of Indianapolis | Long's Bakery"
South Bend: "Martin's Supermarket | Four Winds Casino | the Potawatomi Zoo | Kitchenette II | Ice Box"
New Albany: "Baptist Health Floyd | Feeders Supply | Sam Peden Community Park | The Asian Buffet | Discount Labels"
Elkhart: "Elkhart General Hospital | Simonton Lake Drive-In | Flippin Cow | Bruno's Pizza | Hall Of Heroes"
Hopkinsville: "Davo's | Whistle Stop Donut Shop | Da Vinci | T-Rad North America | Woodshed"
London: "Fiesta Mexicana | Bojangles' Famous Chicken 'n Biscuits | South Laurel Middle School | Frisch's Big Boy | Local Honey"
Madisonville: "Mt. Fuji Hibachi and Sushi | North Hopkins High School | Market Place | Dos Copas | Silver Star burgers fries chicken"
Rocky Mount: "252 Smoke Shop | The Dunn Center | the oakdale baptist church | Rocky Mount Sports Complex | City Lake"
Salisbury: "Salisbury VA Medical Center | Towne Creek Commons | Hendrix Barbecue | Cook-Out | Village Inn Pizza"
Durham: "Duke University Medical Center | Costco Food Court | Durham Performing Arts Center (DPAC) | Duke Medicine Pavilion | Durham Bulls Athletic Park"
Lumberton: "San Jose Mexican Restaurant | Agri Supply | Pier 41 Seafood | Cook Out | Del Sol"
Zanesville: "Sunrise Strikes | State Street Market | Hartstone Factory | Olde Falls Inn | Putnam Hill Park"
Mansfield: "Biblewalk | Dairy Land | Mansfield Family Restaurant | Wiener King | Ohio State Reformatory"
Bowling Green: "Wood County Fairgrounds | 4=H Milkshake Barn | Wood County Hospital | Fricker's | Grounds for Thought"
Springfield: "Rural King | Clark County Fair Grounds | Springfield Antique Center | Fricker's | Springfield Extravaganza"
Lancaster: "River Valley Mall | Fairfield Medical Center | Lancaster High School | Castaways | Roosters"
Johnson City: "Food City | James H. Quillen VA Medical Center | China Luck Buffet | Buffalo Mountain Park | Winged Deer Park"
Kingsport: "Warriors' Path State Park | Darrell's Dream Boundless Playground | Fort Henry Mall | Cook Out | Ben Franklin Crafts"
Columbia: "Maury County Park | Apex Recovery | Tennessee Coffee & Smoothie Co. | Mid-Tennessee Bone And Joint Clinic | Lucky Bamboo"
Barlett: "Radnor Lake State Park | Percy Warner Park | The Island in Pigeon Forge | Bridgestone Arena | Centennial Park"
Blacksburg: "University Mall | Cook-Out | Oasis World Market | Top of the Stairs | Benny Marzano's"
Harrisonburg: "Sharp Shopper | Jess' Quick Lunch #2 | Wood Grill Buffet | Mr. J's Bagels & Deli | Valley Lanes Bowling"
Petersburg: "Golden Skillet | Mun Cheese | Yankee Coffee Shop | Simona's | Lower Appomattox River Trail"
Hampton: "Peninsula Town Center | Hampton VA Medical Center | Buckroe Beach | Briarfield Park | Langley AFB BX"
Sheboygan: "Acuity Flagpole (World's Tallest Symbol of Freedom) | Dunham's Sports | Dog Run | Deland Park | Johnston's Bakery"
Waukesha: "Minooka Dog Park | Frame Park | Wonderland Tap | Tally's Tap And Eatery | Woodman's Liquor Store"
La Crosse: "Gundersen Health System | Festival Foods | Mayo Clinic Health System - La Crosse | La Crosse Central High School | Fox Hollow"
Eau Claire: "Olympic Flame | The Growler Guys | Pet Food Plus | Infinity Beverages Winery & Distillery | Oakwood Mall Food Court"
Tomah: "Tomah Health Care Center | Cancun Bay | The Break Room Sports Bar & Grill | Mose Lamb Ice Rink | The Carlton"
Janesville: "Kwik Trip | Festival Foods | Dean Clinic Janesville -East | Cozumel Mexican Restaurant | Palmer Park"
Appleton: "St. Elizabeth Hospital | MACS (Mac And Cheese Shop) | Asian Food Store | Lamers Dairy And General Store | Game Day Sports Bar"
Parkersburg: "JP Henry's | Rural King | the I-77 Little Kanawha River Bridge | Parkersburg City Park | Dollar Tree"
White Sulphur Springs: "The Country Store | The Greenbrier Bowling | The Forum at The Greenbrier | Prime 44 West | Main Dining Room at The Greenbrier"
Clarksburg: "Louis A. Johnson VA Medical Center | Parkette Family Restaurant | T&L Hotdogs | Wonder Bar | Clique Club"
Dover: "Roma Italian Ristorante | Bayhealth Kent General | Touchdown Bar & Grill | Glasgow Deli | US 13 Grill & Catering"
St. Charles: "Saint Charles Towne Plaza | Indian Head Rail Trail | Food Court at Saint Charles Towne Center | Dorchester | Carrington"
Annapolis: "Graul's Market | Naval Bagels | Double T Diner | Bay Ridge Wine & Spirits | Annapolis City Dock"
Hagerstown: "Robinwood Professional Center | Hagerstown City Park | The Locked Door | Taqueria Jalisco Authentic Mexican Grill | Pennsylvania Dutch Market"
Paterson: "Eastside Park | Brother's Produce | Hinchliffe Stadium | Taşkın Bakery | Red, White And Blue Thrift Store"
Saratoga Springs: "Saratoga Spa State Park | Saratoga Casino and Raceway | Saratoga Performing Arts Center | Saratoga Strike Zone | Uncommon Grounds Coffee & Bagels"
Poughkeepsie: "Walkway Over the Hudson State Park | Vassar Brothers Medical Center | the Adriance Memorial Library | the Darkside Records & Gallery | Mill House Brewing Company"
Plattsburg: "Central Park | Bryant Park | National September 11 Memorial | 9/11 Memorial North Pool | Metropolitan Museum of Art"
Beaver Falls: "Beaver Brewing Company | The Studio Theatre at Geneva College | Oram's Donut Shop | Athens Family Restaurant | Lil Joes"
Altoona: "Logan Town Centre | Angelo Pacifico & Sons Bakery | Mansion Park | Gourmet Buffet | Gardners Candies"
Williamsport: "The Harvest Moon | Dolly’s Diner - West | Buzzsaw Coffee | Journey Bank Ballpark at Historic Bowman Field | Faxon Bowling Lanes Inc"
Lancaster: "Shoppes At Belmont | Wegmans Market Café | Park City Center Food Court | Dragon Hibachi & Sushi Buffet | Park City Diner & Coffee Shop"
Allentown: "Coca-Cola Park | St. Luke's Hospital - Sacred Heart Campus | PPL Center | Supremo Food Market | Elias Farmer's Market"
San Fernando: "Estadio Municipal | Lider | Colegio Americano | ABCDIN DecoHogar San Fernando | Parroquia San Agustín"
Brownsweg: "Brokopondo | Brownsweg | Nieuw Ganzè"
Moengo: "Surpost Moengo | August A. Meijer Congresshall | Ronnie Brunswijkstadion | Kibii Wi Koni Marcel Pinas The Event | V.H.J.I Moengo"
Nieuw Amsterdam: "’T Vcm Hoekhuis"
Waterville: "Elm Plaza | Mardens | MaineGeneral Medical Center's Thayer Center for Health | Erica's | Caswell's Discount Wholesale"
Calais: "Marden's | Tradewind's Shop 'n Save | Crumbs Cafe & Bake Shoppe | U.S.Customs | Calais Waterfront Walkway"
Houlton: "County yankee | U.S./Canada Border | Dunn's Furniture | Marden's | Market Pizza"
Benton Harbor: "Benton Harbor High School | North Pier Brewing Company | Grand Crossing Bar & Grill | North Shore Inn | Houndstooth"
Battle Creek: "Lakeview Square Mall | McGonigle's Pub & Grill | Horrock's Farmers Market Bar | Hots | Lucky Rooster Kitchen & Cocktails"
Bay City: "Bay City Mall | Jack's Market | Krzysiak's House Restaurant | Governor's Quarters | South side market"
Alpena: "Neiman's Family Market | Nowicki's Sausage Shoppe | Austin Brothers Beer Company | Pompeyo’s Mexican Grill | Court Yard Ristorante"
Iron Mountain: "Super One Foods | Lume | Storheim's | Iron Mountain High School | Famers Sports Bar & Grill"
Ironwood: "Higher Love Cannabis Dispensary Ironwood | Super One Foods | High Profile Of Ironwood Dispensary | Levels Cannabis | The Fire Station Cannabis Co."
Sand Point: "Aleutian China Restaurant | Trident Seafoods Corporation | Anchor Inn & Lounge | Peter Pan Sandpoint Docks | North West Company"
Hydaburg: "Hydaburg Cooperative Association | Hydaburg Health Center | Hydaburg High School Gym"
Atqasuk: "Meade River Boat Access | Atqasuk | P&J Store | United States Postal Service | Tauqsigvik"
Port Heiden: "Port Heiden, Alaska"
Perryville: "Perryville"
Dillingham: "Peter Pan Seafoods | Sea Inn Bar | Twin Dragon | Curyung Tribal Council | Dillingham Chamber Of Commerce"
Goodnews Bay: "Rocky Mountain School"
Mountain Village: "Mountain Village | Alaska Commercial"
Emmonak: "Emmonak Sub-Regional Clinic"
Kaltag: "Kaltag"
Teller: "Teller Town"
Koyukuk: "Ella B. Vernetti School | Koyokuk Tribal Council"
Talkeetna: "Denali Brewing Co. | Talkeetna River Park | Fairview Inn | Frontier Gifts | Aurora Dora"
Whittier: "Anton Anderson Memorial Tunnel | Portage Pass Trail | Wild Catch Cafe | Lazy Otter | the Whittier Historical Museum"
Montana: "Montana Creek | Montana Creek Campground | Montana Creek Dog Mushers Race Track"
Lake Minchumina: "Lake Minchumina | the Lake Minchumina Library | Lake Minchumina, Alaska"
Cantwell: "Cantwell Lodge | Jam Jam’s Spot | Cantwell RV Park | Pats Field Site | Drashner Lake, Cantwell, Alaska"
Gulkana: "Gulkana River Raft Rentals | Gulkana | TPU California | Ramayana Of France"
Eagle: "National Park Service | Eagle, AK | US Courthouse"
Nenana: "Serum Run Start | the Alaska Native Veterans Memorial Bridge | Railroad Museum, Nenana Depot | Alfred Starr Nenana Cultural Center | Coghill’s General Store"
Big Delta: "the Alaska Oil Pipeline Suspension Bridge | Quartz Lake | Tanana River | Polaris Junction | Tanana Adventure Sports"
Allakaket: "Allakaket"
Tanana: "Tanana Ira Council | the Tanana Community /School Library Central Library | Tanana Tribal Council, Tanana Health Center"
Vicente Guerrero: "Menudo El Pariente | Estadio Miguel Valdez | IMSS Prospera 69 | El Globo | Calimax Vicente Guerrero"
Loreto: "Supermercado "El Pescador" | Serrano "Wine, Seafood & Grill" Loreto | Malecón de Loreto | LEY Express | Parque Nacional Bahía de Loreto"
Ciudad Constitucion: "Marisqueria El Tiburon | Aurora | Plaza Nayro's | Coppel Constitución | Japan Sushi"
Allende: "Plaza Central Allende, Coahuila | Super Gutiérrez | Cafeteria Minerva | NONAME COFFE HOUSE | Óptica Visión"
Nueva Rosita: "Jugos Veracruz | La Puntada | Neveria alaska | Dominica | Plaza Principal"
Hidalgo del Parral: "La Mision (Santa Fe) | Los Pinos | La Puerta del Tiempo | Birrias Franco | Chao Pescaos"
Ascension: "Local Ascencion.Distribuidor Autorizado Telcel | Ascención | Marisqueria Lolo | Ferretera Central | Floreria la Gardenia"
Gomez Palacio: "Alsuper Store | Plaza de armas | Soriana | Farmacia Guadalajara | Cooperativa Agropecuaria"
Canatlan: "Cow Boy Steak Grill | A5 Restaurant | El Aleman | Pizzas El Girasol | Oxxo Canatlan"
Villa Union: "El Cuchupetas | Star store minisuper | Pasteleria Panama | Taqueria El Mono Y Los Monitos | Coppel"
Altata: "La Güera | Altata Fest | Marisco Jesus | Risa en vacaciones "Altata" | CETMAR Altata no. 28"
Magdalena: "Bodega Aurrera | Magdalena | Asadero Momos | Coppel Magdalena | Oxxo"
Nacozari Viejo: "Mariscos Los Tumbados | El Sonorense | Maquina 501 Monumento Historico A jesus Garcia | Pinacate's mall international bussines center club and spa | Luna's"
Villanueva: "FEREVI | Templo de San Judas Tadeo | Carnitas El Jacal | farmacia guadalajara | Birrieria El Charro"
Montemorelos: "Rocca Rocca | Flipy Mariscos | Plaza Comercial Paseo Fundadores | Cinépolis Paseo Fundadores (Cinépolis) | Milton Tacos"
Sabinas Hidalgo: "Los Jacales | la fogata | Siberbiana | Restaurant Sillares | Super 85"
Cardenas: "Quesos De Magozal | Mercado Cárdenas | Presidencia Municipal  Cardenas | Bodega Aurrera, Cárdenas, SLP | Restaurante El Casal"
Ciudad Valles: "Plaza Principal | Laca Laca | Glorieta Hidalgo | Rincón Huasteco | Steren"
Rio Verde: "Cafe Maria's | Plaza Principal | Las Cazuelas | Las Isabeles | La Querencia"
Ciudad Mante: "La Cabaña De Don Nico | Plaza de Armas | Plaza Principal | Terraza Tina ll | Soriana"
Reynosa: "Plaza Sendero Periférico | Plaza del Río | Plaza Real | Soriana Híper | Entre Aroma Y Cafe"
Ciudad Madero: "Playa Miramar | Walmart Miramar | Plaza Gobernadores | Malecón de Ciudad Madero | Mi Pueblito"
Autlan: "Alameda Municipal | Callejon del Vicio | Mercado Juárez | El Cortito Restaurant | Parroquia del Señor de la Misericordia"
Ciudad Hidalgo: "Mr Fitness | Ciudad Hidalgo | Carnitas Zinapecuaro | El  Barco | Burritos "El pinole""
Apatzingan: "Bodega Aurerrá | Mercado Aguate | apatzingan | Chavindecas "Rosy" | Mariscos Mike Jr."
Santiago Ixcuintla: "Bodega Aurrera Santiago Ixcuintla | Estadio Revolucion | Los Vitrales Restaurant-Bar (Hotel Casino) | Mercado Municipal | Farmacia Guadalajara"
Juchitan: "Juchitan | Mercado de Juchitan | Taquería Lety | Mercado 5 De Septiembre Juchitán | Bodega Aurrera"
Miahuatlan: "PALACIO MUNICIPAL DE MIAHUATLÁN OAXACA | La Herencia Cenaduria | Papeleria "El Niño Sabio" | La Haciendita | La Mezcala"
Atlixco: "Centro Comercial Moraleda | Zócalo | Mercado Benito Juárez | Axocopan | Parque Colón (Zócalo)"
Acatlan: "Mercado Acatlán | Parroquia De San Juan Bautista Acatlan | Presidencia Municipal de Acatlán de Osorio | Zócalo | Las Palapas"
Paraiso: "Oxxo Petrolera | Cinepolis Paraíso | Parque Central Venustiano Carranza Paraiso | Cafe Dolce Vita | Plaza Paraíso"
Balancan: "La Michoacana | Pato's super xpress | Veterinaria Leon | Quesos San Marquitos | casa de la Cultura"
Tlaxcala: "Gran Bodega | Walmart Estadio | Mercado de Tlaxcala. "Emilio Sanchez Piedras" | Michelandia Tlaxcala | Taquería "Los Magueyes""
Irapuato: "Plaza Cibeles | Cristalita | Tacos El Tío | Plaza Delta | Taqueria Los Angeles"
Celaya: "Galerías Celaya | Parque Alameda Central | La Favorita Abarrotes | La Notte | Sushi Roll"
Chilpancingo: "Taqueria "El Buen Sabor" | Tacos Al Carbón El Padrino | Tecuán | Mercado San Francisco | Taco Rock"
Iguala: "El buen gusto | Mercado Adrian Castrejon | Sam's Iguala | Museo de la Bandera | El Cuais Tortas y Jugos"
Tecpan: "Catedral de Técpan | Mercado de Tecpan de Galeana | La Fogata | Caseta tecpan | Torre Médica Tecpan"
Atoyac: "UNO Café | Zócalo de Atoyac de Álvarez | Super Che | Antojitos MARU | Oxxo"
Nezahualcoyotl: "Mercado  Raul Romero | Tianguis de la Impulsora (Domingos) | Toks | Mercado Nuevo Evolución Oficial | Farmacia Linda"
San Juan del Rio: "Finca Santa Veracruz | Plaza Paseo San Juan | Walmart Avenida Central | Mercado Juarez | Hamburguesas al Carbón "La Cabaña""
Jaltipan: "La Iglesia De Jesucristo De Los Santos De Los Últimos Dias | Parque central | Taqueria Los Primos | Parque "20 De Noviembre" | Don Nato"
Orizaba: "Plaza Valle | Alameda de Orizaba Francisco Gabilondo Soler "Cri-cri" | Mercado Zapata | Chedraui | Papa John's"
Xalapa: "Plaza Las Américas | Fuente de Sodas | Urban Center Xalapa | Selecto Chedraui | iHop"
Nautla: "Parque Constitucion Nautla | Super Fasti | Restaurant “La Parroquia” | Puente Nautla | El Paso de las Damas"
San Cristobal de Las Casas: "DRX Crossfit | El Mezcalito | Restaurante Hacienda Club La Diligencia | Xpressions Skatepark | Tianguis de Artesanías "Santo Domingo""
Escuintla: "Oxxo Escuintla | Bodega Aurrera | El Establo | Unidad Deportiva | La Borrachela"
Motul: "Parque de Motul | Huevos motuleños doña Evelia | Bodega Aurrerá | Bar Buenfil Museo Del Beisbol | Palacio Municipal"
Tekax: "Parque Principal De Tekax | Ventanilla Única Estatal (Vue) Tekax | Parroquia San Juan Bautista | Restaurante El Huinic de la Ermita | Ermita de San Diego de Alcalá"
Peto: "Mercado De Peto | Parque Principal de la Ciudad de Peto | Refacciones y bicicletas "La Aurorita" | El Mero Mero (ronald) | Palacio Mpal Peto"
Halacho: "Iglesia La Esperanza | Ya’axche | Lonchería La Fátima | Bizarro nigth | Rejon Puch Luis Enrique"
Ciego de Avila: "Parque Jose Marti | La Fonda Cubana | Ranchon Cimex Sabor Cubano | El Avión Restaurante | La Gorra"
May Pen: "Sinclair's Texaco | Singer | Tracey's Cook Shop | Step to Work Centre | Georges Pool Stop & Bar"
Spanish Town: "Cathedral of St Jago de la Vega | Spanish Town Hospital | Shopper's Fair | Imperial Optical | Juici Patties"
San Antonio de los Banos: "Plaza de la Revolución | Plaza de Armas | Plaza de San Francisco | Plaza de la Catedral | Parque Lennon"
Guines: "Plaza de la Revolución | Plaza de Armas | Plaza de San Francisco | Plaza de la Catedral | Parque Lennon"
Neiba: "Cibusbistro | Parque Neyba | Neyba | Hospital San Bartolome | Batalla"
La Vega: "A Punto De Nieve | Plaza Jacaranda | La Sirena | Parador El Pino | La Baita"
San Francisco de Macoris: "Bravo Bar & Liquor | Restaurant Dorado | Moya Bar Licor Store | Café Repostería Yoma | El Triangulo Liquor Store"
Selkirk: "Red River Co-op Food Store | Selkirk Mental Health Center | Robert Smith School | St Clement's Church Yard (Cemetery) | Lord Selkirk Regional Comprehensive Secondary School"
Berens River: "Mee Mee Wee Si Pi Sports Complex | Berens River Reserve | Robertson Hughie | Northern Store"
Pukatawagan: "Roman Catholic Rectory | Mathias Colomb Cree Nation Youth Drop in Centre | Welfare Office | Royal Canadian Mounted Police | Mathias Colomb Band Government"
Gimli: "Gimli Watershed | Gimli Community Health Centre | Winnipeg Beach | Gimli Super A Foods | Dairy Queen"
Island Lake: "Kistiganwacheeng Elementary School | Tim Hortons | KFC | Garden Hill Community Health | Garden Hill High School"
Melville: "Kim's Your Independent Grocer | Melville Disc Golf Course | Melville Agri-Park | The Bargain Shop | Community Works Building"
Weyburn: "Wholesale Club | Weyburn Co-Op Convenience Store | Dollarama | River Park | Tatagwa View"
La Ronge: "Kosta's | The Zoo Beverage Room | Liquor Store | Lac La Ronge Indian Band | Bargain Center"
Stony Rapids: "RCMP Detachment | Northern Stores | White Water Inn Restaurant | Al's Place | Stony Rapids"
Camrose: "Dollarama | Bailey | Encana Arena | Bedshittters Beware | Big Valley Jamboree"
Hinton: "Rojo Marrón Mexican restaurant & café | the Beaver Boardwalk | Masters Sports Lounge | The Old Grind | Kimchi House"
Vegreville: "Vegreville Pysanka | Vegreville Grandstand | Bamboo Chopstick Restaurant | red cup distillery | Vito's"
Stettler: "Performing Arts Centre (PAC) | Points West Living Stettler Inc | Lawlor Jewelry | Stettler Community Health Centre | Bloke's Bakery"
Lac La Biche: "Sir Winston Churchill Provincial Park | Truckers Saloon | DrP C Holzman | Lac la Biche Canadian Native Friendship Centre | Paul Richard Memorial Park"
Wetaskiwin: "Dollarama | Wok N Roll | Subway | Beans Coffee Bar And Bistro | Civic Centre Twin Arenas"
Creston: "The Brunch Club | Wild North Brewing Company | Pealow's Your Independent Grocer | Jimmys Pub | Kokanee Brewery"
Cranbrook: "East Kootenay Regional Hospital | Fenwick & Baker | Hot Shots Cafe | Tamarack Centre | Northern Reflections"
Terrace: "Bert's Deli | Terrace Farmer's Market | BC Liquor Store | ZBoat Lodge | Skeena Mall"
Chilliwack: "Chilliwack Cultural Centre | Beauty Boutique by Shoppers Drug Mart | Shandhar Hut | Prospera Centre | Rotary Trail"
Hall Beach: "Tim Hortons"
Lutselke: "Lutsel K'e Coop"
Hay River: "Super A Foods | Ring's Pharmacy | North Mart | Hay River Territorial Park | The Doghouse Sports Bar"
Déline: "Co-op | Glen's Your Independent Grocer | Trevor's Your Independent Grocer | Yukon Brewing | Caribou Crossing"
Paulatuk: "Paulatuk Hamlet Office"
Tsiigehtchic: "Church Of The Holy Name Of Mary | Tsiigehtchic"
Owen Sound: "Westside Bowl | Harrison Park Inn | Heritage Place Shopping Centre | LCBO | Zehrs"
Orillia: "Thai Plate | Mark IV | Mariposa Market | Couchiching Beach Park | Theo's Eatery"
Kapuskasing: "Your Independent Grocer | Walmart | Back To The Grind | Sensenbrenner Hospital | O'Briens Bar & Grill"
Thessalon: "Tim Horton's | Forestland | Peace Park | Lakeside Park | Thessalon pizza"
Geraldton: "North Shore Outreach Program | Robin's Donuts | Superior Court of Justice | North Star Conveniences | Thunderbird Friendship Centre of Geraldton"
Belleville: "Quinte Mall | McDowell’s Your Independent Grocer | Value Village | East Side Mario's Belleville | Taste Of Country"
Sarnia: "Clearwater Arena | Lambton Mall | Farmer's Market | Two Amigos | Canatara Beach"
Peterborough: "Lansdowne Place | Morello's Your Independent Grocer | Shoppers Drug Mart | Peterborough Memorial Centre | the Riverview Park & Zoo"
Oshawa: "Oshawa Centre | Harmony Valley Dog Park | Delpark Homes Centre | Teddy's Restaurant & Deli | Lakeview Park"
London: "Masonville Place | Heeman's | White Oaks Mall | SuperKing SuperMarket | The Rec Room"
Kitchener: "Sunrise Shopping Centre | The Boardwalk | CF Fairview Park | Food Court | Zehrs"
New Liskeard: "Davy's Your Independent Grocer | Dollarama | the Empire Theatre | Wild Wing | 28 On The Lake"
Brockville: "Brockville General Hospital | St. Lawrence Park | 1000 Islands Plaza | Cowan's Neighbourhood Store & Dairy Bar | Blockhouse Island"
Port-Menier: "Auberge Port-Menier | Canadian Post | Marché Richelieu - Coop De Consommation De L'ile D'anticosti | Home Hardware | L'Accommodeur Malouin Inc"
Riviere-du-Loup: "CHRGP Centre Hospitalier Régional du Grand-Portage | Parc des chutes de Rivière-du-Loup | Restaurant le Tournesol | Bis La Boulange | Mini-Putt Casse-Croûte"
Drummondville: "Marché public de Drummondville | Maison des arts Desjardins Drummondville | Le Roy Jucep | Édifice Francine-Ruest-Jutras | Village Québécois d’Antan"
Sherbrooke: "Canac | Siboire | Palais des Sports | Chez Stanley Resto-Bar | Louis Luncheonette"
Cap-Chat: "Camping Au Bord De La Mer | Les Chalets Valmont | Valmont Plein Air | Maison du gardien du phare de Cap-Chat | Baie des Capucins"
Baie-Comeau: "Chez Gréco | Microbrasserie St-Pancrace | Distillerie Vent Du Nord | Manoir du café | Jardin Des Glaciers"
Natashquan: "Magasin Jean Landry | Centre d’interprétation : Le Bord du Cap | Café de L'Échouerie | Le Goût Du Large | Vieille école de Nathasquan"
Eastmain: "Bell Canada | Cree Trappers Association | Eastmain, Quebec | Cree Nation of Eastmain | Northern Stores Inc"
Schefferville: "Conseil de la Nation Innu Matimekush-Lac John | Caribou Bar | Ville de Schefferville | Dispensaire de Schefferville | Ungava Caribous Expeditions"
Amos: "Dépanneur de l'Est | Dollarama | Buffet Suco | Complexe Sportif | Chevaliers De Colomb"
Joliette: "La Distinction | Club de tir Lanaudière | Bibliothèque Rina-Lasnier | Brasserie artisanale Albion | Galeries Joliette"
St.-Jerome: "Bedondaine & Bedons Ronds | Parc Jean-Drapeau | Mont Orford | Parc Omega | Parc de l'Île St-Quentin"
St-Augustin: "Centre de santé de Pakua Shipi | Centre de Sante de Pakua-Shipi | Groupe Leclerc | St. Augustine School | Scrapy"
Rouyn-Noranda: "Promenades du Cuivre | Pub Goût Gueule | Olive et Basil | Depanneur Chez Ti-guy | Chez Morasse"
La Sarre: "Consommation Plus Inc | Brasserie La Brute du Coin | Toujours Mikes | Club De Golf Beattie | Bar L’Alambic"
New Glasgow: "Pictou County Wellness Centre | Real Atlantic Superstore | Sam's Family Restaurant | Giant Tiger | Aberdeen Hospital"
Liverpool: "Liverpool Curling Club | Nslc | Fort Port Lighthouse Park | Liverpooooool | Pine Grove Park"
Amherst: "Dollarama | Highland Market | Dayle's Dept. Store | Amherst Stadium | House Of Birria"
Baddeck: "NSLC | Victoria Farmers Co-op Baddeck | Alexander Graham Bell National Historic Site | Tom's Pizza | The Freight Shed At The Terrace"
Deer Lake: "Foodland - Deer Lake | Jungle Jim's | Off The Hook Fish & Chips | Mary Brown's Chicken & Taters | Deer Lake Irving Big Stop"
Hopedale: "Canadian Post | Mapping the Way"
Happy Valley - Goose Bay: "Mary Brown's Chicken | Terrington Co-Op | Tim Hortons | E. J. Broomfield Memorial Arena | Canadian Forces Base Goose Bay"
Port Hope Simpson: "Jc Variety | Alexis Hotel | Penney’s Pitstop | P&B Supermarket (Clover Farm) | Blow Me Down Trailhead"
Tofino: "Coop Foodstore | Cox Bay | North Chesterman Beach | Tofino Brewing Co. | Tacofino"
Virginia: "Super One | Natural Harvest Food Co-op | Dave's Pizza | F & D Meats | Sawmill Saloon & Restaurant"
Winona: "Midtown Foods | Bloedow's | Garvin Heights City Park | Signatures | Mango's Mexican & American Grill"
Rochester: "Scheels | Fleet Farm | Colonial Lanes | Rochester National Volleyball Center | Bowlocity Entertainment Center"
Lakeville: "The Red Fox Tavern | Lakeville Liquors | Emagine Lakeville | the Hosanna Lutheran Church | the St Johns Lutheran Church"
Ely: "Zup's | Antlers Lounge | Whiteside Park | BoatHouse Brewpub & Restaurant | Northern Grounds"
Moorhead: "Fryn' Pan | Junkyard Brewing Company | bus stop | Robert Asp Elementary | BioLife Plasma Services"
St. Cloud: "St. Cloud Hospital | CentraCare Health Plaza | Star of India | Coyote Moon Grille | Pantown Brewing Company"
Miles City: "Miles City KOA | Eastern Montana Fairgrounds | Wibaux Park | Builders FirstSource | Town & Country"
Bozeman: "Rosauers Food And Drug | Town Pump | Gallatin Valley Mall | Bridger Brewing | City Brew Coffee"
Glasgow: "Glasgow Civic Center | Durum Restaurant & Lounge | Frances Mahon Deaconess Hospital | Reynolds Market | Eugene's Pizza"
Dickinson: "Cash Wise Foods | Sanford Health Dickinson Clinic | King Buffet | Players Sports Bar & Grill | JD's BBQ"
Jamestown: "Hugo's | Voorhees Chapel | Drift Praire Brewing Company | Jamestown High School | Newman Arena"
Williston: "Cash Wise Foods (Formerly Economart) | Williston Area Recreation Center | Williston High School | Lonnie's Roadhouse Cafe | Sportsman's Warehouse"
Lihue: "Duke's Kauai | Harbor Mall | The Musubi Truck | Koi Pond | Kukui's on Kalapaki Beach"
Wahiawa: "Schofield Barracks PX | Shoppette/dominos | Green World Farms | Whitmore Community Center | Wahiawa Town Center"
Wailuku: "Maui Memorial Medical Center | Tiffany's Restaurant & Bar | TJ's Warehouse Outlet | Ululani's Hawaiian Shave Ice | Takamiya Market"
Montpelier: "Bear Lake Animal Hospital | Arctic Circle | Bear Lake Drug | the Butch Cassidy Bank Robbery Museum | Instacare"
Twin Falls: "Magic Valley Mall | Swensens Markets | Base Camp | Anchor Bistro & Sports Bar | Perrine Bridge Scenic Overlook"
Caldwell: "Garbonzos Pizza | Vision Specialist | Caldwell Bowl | St. Luke's Clinic Kidney and Hypertension: Caldwell | Idaho Pizza Company"
Salmon: "Saveway | The Savage Grill | Shady Nook Restaurant & Lounge | Sacajawea Center | Salmon River Coffee Shop"
Coeur d'Alene: "McEuen Park | Best Sandwich Shack | Dockside | The Landings Park | The Cedars Floating Restaurant"
Richland: "Howard Amon Park | Country Mercantile | Badger Mountain Dog Park | Dutch Bros | Yoke's Fresh Market"
Bellingham: "Bellis Fair Food Court | Cruisin Coffee | Value Village | Cocoanut Grove | PeaceHealth St. Joseph Medical Center"
Longview: "Mary's Bar & Grill | Lake Sacajawea | Triangle Tavern | Don Pedro's Mexican Restaurant | Boondox Market"
Walla Walla: "Albertsons | Pioneer Park | St. Mary's Medical Center | Walla Walla Clinic | Bi-mart"
Aberdeen: "The Marketplace | Swansons | Welcome To Aberdeen - ‘Come As You Are’ | the Heron Street Bridge | Aberdeen Goodwill"
Bremerton: "Tracyton Public House | The Garage | Aceituno’s | All American Resturanr | Kitsap Regional Library - Sylvan Way"
Everett: "Everett Mall | Costco Food Court | Angel of the Winds Arena | Kasch Park | Costco Pharmacy"
Bullhead City: "Bullhead Community Park | D'Angelo's Italian Restaurant | Gas N Grub | Rotary Park & Launch | Chaparral Golf & Country Club"
Winslow: "Standin' on The Corner Park | Darrell's Rootbeer Stand | Ninis Kitchen | Winslow Elks Lodge #536 | Falcon Restaurant & Lounge"
Gila Bend: "Gila Bend - Butterfield Trail | Space Age Restaurant | Little Italy Pizza & Italian Restaurant | 911 Memorial Park | Sofia's Mexican Food"
Tombstone: "The Original Bird Cage Theatre Of Tombstone | O.K. Corral | Big Nose Kate's Saloon | Tombstone Antique Mall | Tombstone Brewing Company"
Willcox: "Country Pride | Willcox High School | Northern Cochise Community Hospital | La Unica | Big Tex BBQ"
Scottsdale: "The Promenade | Harkins Camelview 14 | Barrett-Jackson Auction - LifeStyle Pavillion | The Stadium Course | the Scottsdale Waterfront"
Kingman: "Cerbat Elementary | Bank Street Grinders | the College Park Community Church | La Senita | Centennial Park"
Grand Canyon: "Bright Angel Trail | Canyon Village Market & Deli | Bright Angel Gift Shop | Hopi House | El Tovar Dining Room and Lounge"
Arcata: "Murphys Market Westwood | Murphy's Market | Toni's #1 | Arcata Community Pool | Arcata Marsh and Wildlife Sanctuary"
Stockton: "Lincoln Center | Sherwood Place | Park West Place | Stockton 99 Speedway | Don Luis Méxican Restaurant"
Barstow: "Lenwood Discount Market | Jasper Park | Park In The Heights | the Skyline Drive In Theater | Outlets at Barstow"
Victorville: "Vallarta Supermarkets | Village Park | Emma Jean's Holland Burger Cafe | Doris Davies Park | Sunset Ridge Park"
Pasadena: "Rose Bowl Loop | Brookside Park | Rose Bowl Flea Market and Market Place | Vallarta Supermarkets | Rose Bowl Plaza"
Visalia: "KOA Visalia | R-N Market | Vossler Farms Pumpkin Patch & Corn Maze | Vallarta Supermarkets | Riverway Sports Park"
El Centro: "The Plaza | Hamburger Stand | Bucklin Park | Las Conchitas Bakery | Diosa Cantina"
San Luis Obispo: "Performing Arts Center | Laguna Lake Park | Mustang Lanes | Firestone Grill | Spirit of San Luis Restaurant"
Merced: "Merced Mall | McKee Strawberry Stand | Merced Fruit Barn | Rancho San Miguel | FoodMaxx"
Yuba City: "The Ranch House | The Fountains | Tortilla Flores | Lumberjacks | the St. Isidore Catholic Church"
Redding: "Mt Shasta Mall | Holiday Market | Turtle Bay Exploration Park | The Fly Shop | Shasta Community Health Center"
Santa Rosa: "Taylor Mountain Open Space Preserve | Epicenter Sports And Entertainment | Oliver's Market | Wine Country Cafe & Deli | Kaiser Permanente Medical Center"
Oceanside: "Guajome Regional Park | El Super | Mission San Luis Rey de Francia | Oceanside Beach | So Cal Sports Complex"
Modesto: "El Rematito Flea Market | Taqueria El Maguey | Cost Less Foods | Sutter Gould Medical Foundation | Cost Less"
Irvine: "Irvine Spectrum Center | University Center | Woodbury Town Center | Heritage Plaza Shopping Center | Diamond Jamboree Shopping Center"
Ukiah: "Chavez Market | Low Gap Park | Todd Grove Park | Lalo's | Ukiah Natural Foods (Co-Op)"
Needles: "Needles High School | The Wagon Wheel | Kush on 66 | The Healing Center Medical Marijuana Dispensary | Fort Mojave Indian Tribe"
Bishop: "Erick Schat’s Bakkery | Bishop High School | Lake Sabrina Boat Landing | Bishop City Park | Astorgas"
Palm Springs: "Agua Caliente Casino Palm Springs | Demuth Park | Forever Marylin Statue by Seward Johnson | Indian Canyons | Tool Shed"
Santa Maria: "Far Western Liquor | Vallarta Supermarkets | Pappy's Restaurant | Waller Park | Beth’s Tamales"
Tulare: "Salles Café | Vallarta Supermarkets | Tulare Outlets | Vejar's Mexican Restaurant & Cocktail Lounge | Sno White Drive In"
Mt. Shasta: "Ray's Food Place | Berryvale Grocery | Say Cheese Pizza | Mt. Shasta Supermarket | Mt. Shasta"
Crescent City: "Port O' Pints Brewing Co. | Pacific Ocean | Fisherman's Restaurant | CC's Diner | SeaQuake Brewing"
Fort Collins: "Front Range Village Shopping Center | Twin Silo Park | Arc Thrift Store | City Park | Holiday Twin Drive In"
Pueblo: "Pueblo City Park | Schornack Saloon | Big Bear Liquor | Collette's | Big Daddy's Sunset Bowl"
Lamar: "Willow Creek Park | the Happy Garden | Main Street Shoppe | BJ's Burger and Beverage | Lamar Community Building"
Trinidad: "Tony's Diner | The Santa Fe Tavern | Sunset Grill | Las Animas County Courthouse | The Market Bar"
Gunnison: "Gunnison Coffee Company | Gunnsion National Forest | Pitas in Paradise | Mario's Pizza & Pasta | Path Finder Bear"
Durango: "Durango High School | Durango Recreation Center | Steamworks Brewing Company | Pop Sushi Durango | Durango Mall"
Montrose: "City Market | Backstreet Bagel Company | Horsefly Brewing Company | Clean Choice Car Wash | The Liquor Store"
Craig: "Museum of Northwest Colorado | TMH | Thunder Rolls Bowling Center | Ace Hardware | Centennial Mall"
Boulder: "the Boulder Public Library | Chautauqua Trail | Hazel's Beverage World | Boulder Country Club | Avanti Food & Beverage"
Boulder City: "Boulder City Municipal Golf Course | Hemenway Park | Robert L. Mendenhall Scenic Overlook | Pro Gun Club | Boulder City Cemetery"
Winnemucca: "Mariscos El Rey | Boys & Girls Club of Winnemucca | Highland Park | Humboldt General Hospital | New Frontier RV Park"
Roswell: "Farmers Country Market | International UFO Museum and Research Center | Anderson Museum Of Contemporary Art | Farley's Bar and Grill | Geli's Cafe"
Clovis: "Foxy drive-in | Guy Leeder Complex | Greene Acres Park | Bob Spencer Softball Fields | Leal's Mexican Restaurant"
Las Cruces: "Spotted Dog Brewery | NMSU Golf Course | Field Of Dreams | Mesilla Valley Mall | Si Señor Restaurant"
Hobbs: "Mail Services Etc. | Nipa Hut | Rosa's Cafe | PurLife | Undergrounds Coffee Co."
Socorro: "NMT Golf Course | Water & Ice Store | Socorro Plaza | Blake's Lotaburger | The Capitol Bar"
Gallup: "US Department of Health and Human Service, Indian Health Service, Navajo Area Indian Health Service, Gallup Indian Medical Center | Gallup Flea Market | Blake's Lotaburger | Sundance Dental Care of Gallup | Red Rock State Park"
Raton: "Super Save | Heart's Desire | Oasis Restaurant | Goat Hill Scenic Overlook | K–Bobs"
Tucumcari: "Chester's Chicken | Lowe's | Rocky Mountain Cannabis Tucumcari | Tucumcari Cemetery | La Cita"
Roseburg: "Sherm's Thunderbird | Blac-N-Bleu Bistro | The Kodiak | Chi's Garden Restaurant | Gilberto's Mexican Restaurant"
Pendleton: "Roosters | Eastern Oregon Correctional Instituation | The Prodigal Son Brewery & Pub | Pendleton Woolen Mills | Hal's Hamburgers"
John Day: "Chester’s Markets | The Snaffle Bit Dinner House | 1188 Brewing Company | Grant County Fair Grounds | Squeeze-In"
Grants Pass: "River's Edge Restaurant | Mini Pet Mart | Bi-Mart | Diamond Home Improvement | Reinhart Volunteer Park (All Sports Park)"
Corvallis: "First Alternative Natural Foods Co-Op | Chip Ross Park | Riva's Tacos | the Corvallis-Benton County Public Library | Goodwill"
Albany: "Deerfield Park | Linn County Fairgrounds / Expo Ctr | Lakeshore Lanes | Rigoberto's | Timber Linn Park"
Astoria: "Astoria Column | Fultano's Pizza | Fort George Brewery & Public House | Astoria Co-op | The Goonie's House"
Logan: "Cache Valley Fairgrounds | Tandoori Oven | Gossner's Cheese | Lee's Marketplace | Angie's Restaurant"
Parowan: "Parowan High School | Dairy Freeze | Dede’s Farmhouse Cafe | Parowan Market | iron county fair grounds"
Kanab: "Glazier's Family Market | Honey's Marketplace | Kanab Center | Walker's 7 Eleven | Sego Restaurant"
Monticello: "Blue Mountain Foods | Ja Roen Thai Sushi | Gustavo’s | Monticello Utah Temple | Thatzza Pizza"
Moab: "Moab Food Truck Park | Hells Revenge Trailhead | Walker Drug | Moab Diner | Village Market"
Price: "Carbon High School | Los 2 Amigos | Club Mecca | Sherald's | Dino-Mine Park"
Cedar City: "Bruno's Italian Deli | C-A-L Ranch Stores | Utah Shakespeare Festival | Stadium 8 | Slurps Up"
Vernal: "Khao Hom Thai Kitchen | Gateway Saloon | Vernal Brewing Co. | Uintah Recreation Center | Uintah County Public Safety Complex"
Ogden: "Dylan's | BDO Outlet | Ogden Utah Temple | Kaffe Mercantile | Beto's"
Green River: "Green River High School | Mr Waffles And Crepes | Get Real Coffee | Sweetwater County Court House | Jackson Elementary School"
Rawlins: "Anong's Thai Cuisine | Rawlins High School | Ichiban Japanese Restaurant | Cactus Jack's Restaurant | the Wyoming Frontier Prison Museum"
Douglas: "307 Praire Pantry | Grasslands Market | Blend Coffee & Co. | Douglass High School | Plains"
Riverton: "Speedway Cafe | Ichiban | Central Wyoming College | Perrett's | Brown Sugar Coffee Roastery"
Thermopolis: "The Wyoming Dinosaur Center | One Eyed Buffalo Brewing Company | Super Blair's Market | Hot Springs County High School | Hot Springs State Park"
Gillette: "Cam-plex Wyoming Center | Pizza Ranch | Humphrey's Bar & Grill | Rocky Mountain Discount Sports | Campbell County High School - North Campus"
Jonesboro: "The Mall at Turtle Creek | Craighead Forest Park | Fox Meadow Intermediate Center | the Craighead County Jonesboro Public Library | Sage Meadows Country Club"
Texarkana: "Bubba's 33 | Fat Jack's Oyster Bar | Holiday Bowl | Joe's Pizza and Pasta | Zapata's"
Pine Bluff: "Chef Lee's | Red Oak Steakhouse | Big Banjo Pizza Parlor | Ocean's Fish & Chicken 4 | Hwy 79 south Church of Christ"
Hot Springs: "Oaklawn Racing & Gaming | Sam's Pizza | Harp's | Magic Springs and Crystal Falls Theme Park | Back Porch Grill"
Fort Smith: "Parrot Island Waterpark | Central Mall Fort Smith | Braum's | Spirit 106.3 FM | JJ'S Grill"
Fayetteville: "Northwest Arkansas Mall | Wright's Barbecue | Premier Wine & Spirit | Baum Stadium | NWA Mall"
Conway: "Baptist Health Medical Center | 7 Brew Drive-Thru Coffee | Stoby's Restaurant | Conway Commons Shopping Center | Don Pepe’s Gourmet Tacos and Burritos"
El Dorado: "Oriental Gardens | Spudnut Shoppe | Mac's Fresh Market | Medical Center Of South Arkansas | Open Door"
Davenport: "Rhythm City Casino Resort | West Lake | Vander Veer Park | Mississippi Valley Fairgrounds | Atomic Coffee Bar"
Burlington: "The Buffalo Tavern | Crapo Park | Edward Stone Middle School | Catfish Bend Casino | Starr's Cave Park and Preserve"
Dubuque: "Q Casino | Mines of Spain | Dubuque Driving Range (& Lounge ) | Eisenhower Elementary School | the National Mississippi River Museum & Aquarium"
Waterloo: "Crossroads Mall | George Wyth State Park | Fareway | Family Foot Health Care PLC | Highway 63 Diner"
Sioux City: "Lakeport Commons | Sergeant Floyd Monument | Fareway | Rollerrama | Whispering Creek Golf Club"
Council Bluffs: "Metro Crossing | The Marketplace | Lake Manawa State Park | Mid-America Center | Sugar Makery"
Ames: "McFarland Clinic - Ames Main | Fareway | Perfect Games | The Cafe | Ada Hayden Heritage Park"
Mason City: "LD's Filling Station | East Park Mason City Ia | Village Court Family Restaurant | Chick-fil-A | the State Street Walking Path Bridge"
Emporia: "Flint Hills Mall | Braums | Braum's | Emporia Country Club Disc Golf Course | Radius Brewing Company"
Salina: "Central Mall | Jerry Ivey Park | Salina Regional Medical Center | Braum's | Kenwood Park"
Dodge City: "Farmer's Country Market | Tacos Jalisco | Boot Hill Casino & Resort | El Charro | Boot Hill"
Coffeyville: "El Pueblito | Braum's Ice Cream & Burger Restaurant | LeClere Park | Coffeyville Hospital | Shabby to Chic"
St. Charles: "Gingham's Homestyle Restaurant | Star Club Lounge @ Ameristar Casino | Mid Towne Market | Streets of St. Charles | St. Charles Family Arena"
Poplar Bluff: "Las Margaritas | Physician's Park | Hayden's Drive-In | Colton's Steak House & Grill | the Margaret Harwell Art Museum"
Joplin: "Braum's Ice Cream & Dairy | Food4Less | Freeman Hospital West | Joplin44 Chrome Shop | Stogey's Coney Island"
Columbia: "Mizzou Aquatic Center | Boone Hospital Center | Goodwill Retail Store | Jazz, A Louisiana Kitchen | Lakota at University Hospital"
St. Joseph: "Betty's Cafe | Adams Bar & Grill | The Big Biscuit | Krug Park | Fredrick Inn Steakhouse"
McCook: "Bueno's Taquitos | Red Willow County Fair Grounds | Norris Park | Runza | McCook Community Hospital"
Norfolk: "Sunset Plaza Mall | the Elkhorn Valley Museum | Velocity Clinical Research | the First Christian Church | Bomgaars"
North Platte: "Eisenhower Elementary | Fat Dogs | Cody Park | Great Plains Health Sports & Therapy | Luigi's Italian Restaurant"
Sidney: "Legion Park | The Rock Sports Bar & Grill | Boss City Brewing Co. | Sidney High School | Sonny's super foods"
Scottsbluff: "Regional West Medical Center | Dairy king | the Scottsbluff United Methodist Church | Scottsbluff High School | Sam & Louie's Italian Restaurant & New York Pizzeria"
Chadron: "the St. Patrick's Catholic Church | Wilds Bar and Grill | Wilson Park | Far West | The Ridge"
Lawton: "Comanche Nation Casino | Apache Casino Hotel | Learning Tree Academy | Fort Sill PX | Southwestern Medical Center"
Norman: "Riverwind Casino | Bookmark Cafe | Atwoods | Moore Norman Technology Center | Braum's"
Muskogee: "Creek Nation Casino Muscogee | Braum's Ice Cream & Burger Restaurant | The Castle of Muskogee | Cherokee Nation Three Rivers Health Center | Lakeland Shopping Center"
Ponca City: "Braum's Ice Cream & Dairy Stores | Hunans | Lake Ponca Duck Ponds | Hteao | Enrique's Mexican Restaurant"
Shawnee: "Shawnee Mall | Abuelita Rosa's Authentic Mexican | FireLake Discount Foods | Kickapoo Casino II | Braum's Ice Cream & Dairy Stores"
Woodward: "Braum's | Twisters | Oklahoma and Central Plains Agricultural Research Center | Northwest Eye Associates | Wagg's Bar-B-Q"
Guymon: "Seaboard Foods Plant | The Pub on the Bricks | Bob's | Eddie's | Sunset Hills Golf Course"
Yankton: "the Meridian Bridge | South Dakota Human Services Center | Riverside Park | Fryn' Pan Family Restaurant | Ben's Brew Station"
Brookings: "The Depot Pub | Larson Ice Center | Cubby's Sports Bar and Grill | Java City | Interstate Lake"
Mitchell: "County Fair Food Store | The Corn Palace | Marlins Family Restaurant | Cadwell Park | Palace City Brewing Co."
Aberdeen: "Ken’s SuperFair Foods | Kessler's Food & Liquor | Holiday | Avera Family Physicians | Marlin's Family Restaurant"
Mobridge: "Merkel's Foods | Slumberland Furniture | Pheasant Drive-In | Payless Foods | KT's Fireside Supper Club"
Houma: "Creole Lanes | Big Al's Seafood Restaurant | Cajun Critters | El Paso Mexican Restaurant | Big Mike's BBQ Smokehouse"
Monroe: "Waterfront Grill | Bayou Bowl | Big Momma's Fine Foods | the Louisiana Purchase Gardens & Zoo | Monroe Civic Center"
Conroe: "Montgomery County Fair Grounds | Carl Barton Jr Park | River Plantation Country Club | Vernon's Kuntry Katfish | Phở & Sushi Bar"
Nacogdoches: "Auntie Pasta's | Mike's Barbeque House | Macklemore's Ale House and Bistro | The Forest Ranch | Butcher Boys"
Eagle Pass: "Puente Internacional 1 'Piedras Negras' | Dg Market | International Bridge #2 | International Bridge #1 | Desert Lanes Bowling Center"
Edinburg: "Monte Cristo Golf & Country Club | Los Lagos Golf Club | Stripes Store #2404 | Junior's Super Market | Anitas Cafe"
Kingsville: "King Ranch | El Tapatio | el dorado | CHRISTUS Spohn Hospital Kleberg | SPICE STATION"
Port Arthur: "Tyrrell Elementary School | Jefferson City Shopping Center | Tony's Mexican bar and Grill | the Port Arthur Public Library | Cheddar's Scratch Kitchen"
Huntsville: "Kroger Signature | Potato Shack | Grand Buffet | Sam Houston Statue | City Hall Cafe"
Killeen: "the 3d Cavalry Regiment Museum | Warrior Way Post Exchange | Los Burritos | C.E. Ellison High School | 4th ID Mini Mall"
Lufkin: "Moms Other Diner | The Spud | Chevron, On The Road | Zesty Burger | El Coco Loco"
Del Rio: "Plaza Del Sol Mall | River City Donut & Coffee  House | stripes 2412 | Momo’s Coffee | Luceros Mexican Food Truck"
San Angelo: "Shannon Medical Center | San Angelo State Park | La Esperanza | Bentwood Country Club | Rosa's Cafe"
Sherman: "Sherman Town Center | Fairview Park | 903 Brewers | Braum's | Whitney Food Store"
Beaumont: "Patillo's Barbeque | Chicken Express | J Wilson's | Happy Donut | Ford Park"
Bay City: "Schulman's Movie Bowl & Grille | Diamond S | K 2 Steak House | Medical Arts Clinic | La Casona"
Port Lavaca: "Texas Traditions Grill & Bakery | Bush’s Chicken | La Antigua Mexican Restaurant | Calhoun High School | Habanero's South Texas Cuisine"
Falfurrias: "Brooks County Courthouse Annex | Stars | Falfurrias High School | Taqueria Jalisco | Laredo Taco Company"
Beeville: "Taqueria Vallarta | VFW Hall | the St. Joseph's Catholic Church | the Monte Del Olivar Christian Church | Taqueria Jalisco #3"
Fort Stockton: "Taqueria Guadalajara | Glitzy’s | V's Kitchen | The Grey Mule | K-Bob's Steakhouse"
Pecos: "United Supermarkets | Noodles & Dumplings | Pecos River | Reeves County Hospital (Emergency Room) | Alpine Lodge Restaurant"
Dumas: "Lowes Grocery | Dumas High School | 287 Road House Sports Bar | Moore County Hospital District | Moore County Courthouse"
Denton: "Golden Triangle Mall | Thrift Giant | Braum's | the Old Alton Bridge | CH Collins Athletic Complex"
Midland: "the Midland Beer Garden | La Hacienda Event Center | Green Tree Country Club | Market Street | Midland Memorial Hospital"
Temple: "Temple VA Hospital | Stripes | Lion Junction Water Park | Miller Park | Spec's"
New Haven: "New Haven Green | East Rock Park | West Rock Ridge State Park | Westville | Long Wharf"
Lowell: "Lowell General Medical office | Eggroll Cafe | the Pollard Memorial Library | Shedd Park | Peephuptmei Restaurant"
Worcester: "Lincoln Plaza | White City Shopping Center | The Atrium @ St. Vs | Polar Park | Elm Park"
Manchester: "Mall of New Hampshire Food Court | The Elliot at River's Edge | Apple The Mall of New Hampshire | Aldi Food Market | Chunky's Cinema Pub"
Newport: "the Newport Claiborne Pell Bridge | Cliff Walk | The Breakers | Newport Storm Brewery | Brick Alley Pub & Restaurant"
Dothan: "Smokey Joe's | Folklore Brewing & Meadery | Rural King | Southern Clinic, P.C. | Zack's Family Restaurant"
Tuscaloosa: "Midtown Village | University Mall | Cook Out | Dreamland BBQ | Wrights"
Gadsden: "Food City | Giant Johnson's Food | Pruett's BBQ | Noccalula Falls | Etowah County Department Of Human Resources"
Enterprise: "Santa Fe Cattle Company | Enterprise Mini Golf | Grocery Advantage | Cutts Restaurant | Johnny Henderson Family Park"
Selma: "the Edmund Pettus Bridge | Lannies BBQ | the National Voting Rights Museum | Lannie's BBQ #2 | the tabernacle baptist church"
Coral Gables: "Downtown Coral Gables | the Fairchild Tropical Botanic Garden | The Lennar Foundation Medical Center | Matheson Hammock Park | Chapman Field Park"
Cape Coral: "Farmer Joe's | North Fort Myers High School | Back Streets Sports Bar | Lelulo's | Mangia Bene Restaurant Italian"
Naples: "Tin City | Lowdermilk Beach | the Naples Zoo | 5th Ave S Beach | the Clam Pass Boardwalk"
Fort Pierce: "Fort Pierce Jetty Park | Nelson Family Farms | Joy's Ice Cream | Lawnwood Baseball Complex | Bealls Outlet"
Kissimmee: "Loop West | Shingle Creek Regional Park at Babb Landing | Coliseum of Comics | El Tenampa Mexican Restaurant | Osceola County Softball Complex"
Titusville: "Parrish Park | Dixie Crossroads | the Titusville Public Library | Spca Thrift Store | Victorio's Oyster Bar and Grille / Titusville"
St. Augustine: "the St. Augustine Amphitheatre | The Fountain of Youth Archaeological Park | The Spot | the St. Augustine Lighthouse & Maritime Museum | the Memorial Presbyterian Church"
Ocala: "La Hacienda | I75 Super Flea Market | Rural King | Market At Heath Brook | China Lee Buffet"
Fort Lauderdale: "Holiday Park | Broward Center for the Performing Arts | Elbo Room | Revolution Live | Fort Lauderdale Beach"
Apalachicola: "WaterCraft Brewing Company | Half Shell Dockside | Apalachicola Chocolate & Coffee Company | Franklin County Courthouse | Up The Creek Raw Bar"
Vero Beach: "Mrs. Mac's Fillin' Station | Vero Bowl Lanes & Lounge | South Beach | The Green Marlin Restaurant and Raw Bar | Jaycee Park"
Valdosta: "Wooden Nickel Pub | Cook Out | Valdosta Stadium Cinemas 16 | Cuz's Sports Bar and Grill | Mama June's Country Buffet"
Albany: "Miller Coors Brewery | All American Fun Park: Arcade | OK Beauty & Fashion | Albany Mall | Flint river golf course"
Athens: "Piedmont Athens Regional | The Classic Center | Ben Burton Park | Beechwood Shopping Center | Cook-Out"
Macon: "Amerson Water Works Park | Roses | Central City Park | S&S Cafeteria | Idle Hour Country Club"
Columbus: "Columbus Park Crossing | Cross Country Plaza | Cooper Creek Park | Stars and Strikes | Heath Park"
Douglas: "The Cat Fish House | South Georgia Dentistry | Coffe County Middle School | Clyde's | Lindsey & Wills Animal Hospital"
Dublin: "Crooked Finger Brewing | Hong Kong | Southern Heritage Bar-B-Que | Dublin Mall | Surcheros Fresh Grill"
Gulfport: "Island View Casino Resort | Island View Casino Buffet | Island View High Limt Bar | Gulfport Harbor/Jones Park | The Grocery Depot"
Hattiesburg: "Conni Cones Sno-Balls | Oak Grove Family Clinic | Longleaf Trace @ Jackson Road | Rose's BBQ | Corner Market"
Tupelo: "North Mississippi Medical Center | The Mall At Barnes Crossing | the Elvis Presley's Birth Place and Museum | Veterans Park | Fox's Pizza Den"
Greenville: "Gino's Hamburger | Greenville Country Club | Shipley Do-Nuts | the Delta Brewing Supply & Beer Garden | Greenville Speedway"
Natchez: "Natchez Market #2 | The Bellemont Shake Shop | Natchez Bluff | Magnolia Bluffs Casino | the Natchez-Vidalia Bridge"
Florence: "Florence Mall | KJs Market | 3rd Loop Driving Range | Southern Hops Brewing Company | Cains Bar-B-Que"
Greenville: "The Shops at Greenridge | Costco liquor | Bon Secours Wellness Arena | Falls Park On The Reedy | Lewis Barbecue Greenville"
Sumter: "DeMara's | Sambino's | Sub Station II | Dillon Park | Willie Sue's"
Anderson: "Hibachi Grill And Supreme Buffet | Cook-Out | Little Pigs B-B-Q | EL Jimador | Rainey Fine Arts Center"
Aiken: "Mi Rancho | Aiken Steeplechase | Department Of Motor Vehicles | Grumpy's Sports Pub | West Carolina State Fairgrounds"
Beaufort: "the Hwy 21 Drive-in Theatre | Agave | Spanish Moss Trail Head | Piace Pizza | Henry C. Chambers Waterfront Park"
Rock Hill: "Sportsman, Inc | Strikers Bowling Center | Cook Out | Red Bowl Asian Bistro | Tc's Shaved Ice"
Decatur: "El Rodeo | Royal International Buffet | Diamonds Family Restaurant | Disc Replay | The Wagon"
Alton: "Maeva's Coffee | Castelli's Restaurant at 255 | Fast Eddie's Bon Air | Alton Goodwill Retail Store | Bowl Haven Lanes"
Quincy: "Sprout's Inn | Upper Moorman Park | Coach House Restaurant | Kelly's | El Rancherito Mexican Restaurant"
Urbana: "Champaign County Fairgrounds | High Caliber Training Center & Indoor Range | Urbana Early Childhood School | Salt & Light Urbana | Urbana Golf & Country Club"
Bloomington: "Bloomington High School | ALDI | Grossinger Motors Arena | Habitat for Humanity Restore | Western Tap"
Kankakee: "Great Wall Chinese Restaurant | Blue's cafe | Paul's Place | the Paramount Movie Theater | El Mexicano Restaurant"
Waukegan: "Lewis Fresh Market | Tony's Fresh Market | Taqueria Toluca | Illinois Secretary of State Driver Services Facility | Papa Marcos"
Carbondale: "Murdale, IL | the Vine Community Church | Qin Guan | Neighborhood Co-op Grocery | Quatro's Deep Pan Pizza"
Belleville: "Bel-Air Bowl | Eckert's Belleville Country Store & Farm | National Shrine of Our Lady of the Snows | D.S. Vespers Sports Pub & Eatery | Saigon Restaurant"
Bloomington: "Upstairs Pub | Goodwill Store | Fresh Thyme | Cloverleaf Family Restaurant | College Mall Food Court"
Muncie: "Ball Memorial Hospital | Pizza King | Gibson Arena | Delaware Country Club | Concannon's Bakery"
Kokomo: "the Abundant Life Church | Cone Palace | the Crossroads Community Church | Great Wall Buffet | Half Moon Restaurant & Brewery"
Gary: "Big Daddy's BBQ | Lake Ridge Middle School | Gary Flea Market | El Norteno | Save More Foods"
Fort Wayne: "Jefferson Pointe Mall | Allen County War Memorial Coliseum | the Fort Wayne Children's Zoo | Rich's Cafe | Casa Grille Italiano"
Covington: "Log Cabin Inn | Pioneer Park | Cut In The Hill | Dixie Chili | Covington Tobacco Shop"
Bowling Green: "Basil Griffin Park | Aviation Heritage Park | Beech Bend Raceway | Preston Miller Park | Beech Bend Park"
Paducah: "Banks Market | Kentucky Oaks Mall | Parker's Drive-In | J Bella's | FiveStar Food Mart"
Owensboro: "Sonic Drive-In | Apollo High School | Wasabi 54 | Rolling pin | Ole South Barbeque"
Jacksonville: "Marine Corps Exchange | Carolina Ale House | Onslow Pines | Naval Hospital Camp Lejeune | Mi Cabaña"
Goldsboro: "Walmart Neighborhood Market | D&C Mini-Mart | Cook Out | Herman Park | Bojangles' Famous Chicken 'n Biscuits"
Greenville: "Bills Hot Dogs | Basil's Restaurant & Pizzeria | New River Pottery | Sup Dogs | Cook Out"
Fayetteville: "Freedom Town Center | Cumberland Veteran Affairs Medical Center | Fort Bragg North PX | Airborne PX | Bubba's 33"
Hickory: "Valley Hills Mall | Cook-Out | China View | Stanford Park | The Angus"
Asheville: "Buncombe County Sports Park | WNC Farmers Market | Cookout | Moose Cafe | Papas Pizza"
Winston-Salem: "66 Diner | Dairi-O | Compare Foods | Kermit's Hot Dog House | Delta Arts Center"
Kitty Hawk: "Kitty Hawk Elementary | Barefoot Bernie's Tropical Grill & Bar | ABC Liquors | Mile Marker 1 | Hurricane Mo's Beachside Bar And Grill"
Akron: "Akron Children's Hospital | Gardner Pie Co. | Bob's Hamburg | Magic City Brewing Company | Uncle Tito's Mexican Restaurant"
Lima: "St. Rita's Medical Center | Pat's Donuts & Kreme | Old Barn Restaurant and Grill | Yamato Japanese Steakhouse West | Meat City"
Oak Ridge: "the Oak Ridge Children's Museum | Buff City Soap -Oak Ridge | Golden Oak Grill Buffet | Calhoun's | Books-A-Million"
Murfreesboro: "The Avenue | Stones River Mall | Farmers Family Restaurant | Murfreesboro Medical Clinic | Cook Out"
Clarksville: "Governor's Square Mall | Clarksville Speedway | Beachaven Winery | Catfish House | Heritage Park"
Jackson: "Food Giant | North Park | Cypress Grove Nature Park | Brooksie's Barn | Los Portales Mexican Restaurant"
Alexandria: "Shoppes of Foxchase | the Old Town Waterfront | Green Spring Gardens | Founders Park | Barnside Diner"
Fredericksburg: "Central Park | Spotsylvania Towne Centre | Eagle Village Shopping Center | Park Lane Tavern | Harry's Alehouse"
Roanoke: "Cook Out | roanoke river greenway | El Toreo | Virginia Museum of Transportation | Forest Park School"
Danville: "Cookout | Danview Restaurant | Moon River Thai | dunham's sports | Kickback Jack's"
Winchester: "Sharp Shopper Grocery Outlet | Pack's Dairy Corner Frozen Custard | Jim Barnett Park | Winchester Medical Center Emergency Department | FoodMaxx"
Bristol: "At The Cross | Books-A-Million | Mr. Lucky's | The Corner Dog House | Bella's"
Superior: "Mama T's Smokin Eats | Village Lanes | Kingdom Hall-Jehovah's Witness | St Marys Hospital Of Superior | Club 35"
West Bend: "Fleet Farm | Washington County Human Services | Regner Park | The Charcoal Grill | King Pin Bowl & Ale House"
Fond du Lac: "Lakeside Park | Forest Mall | Schmitty's Oar House Bar & Grill | Gilles Frozen Custard | Dutch's Trading Post"
Oshkosh: "Menominee Park | The Outlet Shoppes at Oshkosh | Bare Bones Brewery | Oshkosh North High School | Ruby Owl Tap Room"
Rhinelander: "Trig's | Friendship House | Rhinelander Ice Arena | Hodag Park | Golden Harvest"
Racine: "Racine Curling Club | West Town  Food Liquors | El Rodeo | Johnson Park | Castle Lanes"
Marinette: "Pine Tree Mall | Apple Jack's Bar & Grill | Jack's Cleveland | Tyco Fire Products | Goodwill Industries of Northern Wisconsin and Upper Michigan"
Wheeling: "Riesbeck Food Markets | Oglebay Park | WesBanco Arena | Pickles' | Good Zoo and Benedum Theater at Oglebay Resort"
Morgantown: "WVUH Physician Office Center | Fat Daddy's Bar and Grill | Varsity Club | Kegler's Sports Bar & Lounge | White Park"
Huntington: "St. Mary's Medical Center | Cabell Huntington Hospital | Cook Out | Ritter Park | Tudor's Biscuit World"
Beckley: "Wasabi Fusion | Pasquale's | John eye big sandy | Cook Out | Calacino's Pizzeria"
Wilmington: "Pete's Pizza | China House Express | Chase Fieldhouse | Brandywine Park | Salesianum School"
Cumberland: "Western Maryland Health System | Puccini Restaurant | Oscar's Restaurant | Kline's Restaurant | C&O Canal/Towpath"
Atlantic City: "The Quarter at Tropicana | Hard Rock Lobby Bar | Hard Rock Live at Etess Arena | B Bar | Boardwalk Hall"
Newark: "Prudential Center | Newark Beth Israel Medical Center | Branch Brook Park | Newark Knights | Soul Food Chess House"
Schenectady: "Rivers Casino & Resort | Alltown Fresh | Central Park | Sportsmans Bowling Academy | DeAngelo's Ristorante"
Binghamton: "Otsiningo Park | Little Venice Restaurant | Recreation Park | Robot City Games and Arcade | Thai Thai Cuisine"
Utica: "North Utica Shopping Center | Ventura's Restaurant | Utica Coffee Roasting | the Utica Zoo | O'Scugnizzo Pizzeria"
Watertown: "Bear World | The Cowlick Ice Cream | Case Middle School | Lotus Restaurant | Thompson Park"
Niagara Falls: "Terrapin Point | Niagara Falls State Park | Niagara Falls (American Side) | Observation Tower | Zehrs"
Jamestown: "WCA Hospital | Milton J. Fletcher School | Lucille Ball's Gravesite | Farm Fresh Foods | Jamestown High School - JHS"
Elmira: "Pietro & Son | Diven Elementary School | Bernie Murray's | Pudgies Pizza | King Kone"
York: "York Fairgrounds & Expo Center | Memorial Hall | Mission BBQ | Chiropractic Athletic Center | Rita's Italian Ice & Frozen Custard"
Johnstown: "Roxbury Park | Boulevard Grill | Habits | Franklin Street Bar & Grill | T N C's Lounge"
Scranton: "Gerrity's | Gerrity's Supermarket | Gerritys | Alfredo's Pizza Cafe | Maroni's Pizza House"
State College: "Berkey Creamery | Federal Taphouse | Far Corners Oriental Market | Café 210 West | Irving's"
Erie: "Perry Square | Erie Insurance Arena | Golden Wok | Odis 12 Bar & Grille | New York Lunch"
Wilkes Barre: "Schiel's Family Market | VA Medical Center | R/C Wilkes Barre Movies 14 | Patte's Sports Bar & Restaurant | Kirby Park"
Nieuw Nickerie: "Willemsplein, Nieuw Nickerie | Hong Kong II Restaurant | Doergamall | Restaurant New Kowloon | Hong Kong I Restaurant"
Brokopondo: "Brokopondo | Afobaka Resort | Fargo's Place | Brownsweg | Fredberg | Atjoni"
Totness: "Eethuis Amelia | Totness, Coronie | Surpost Coronie | Letitia Vriesde Stadion, Coronie | Coronie (Totness) | Coronie Exploitatie Project (Paradise Oil Company N.V.)"
Bar Harbor: "Thunder Hole | Cadillac Mountain | Sand Beach | Sand Beach Overlook | Jordan Pond Path"
Lewiston: "Pettengill Academy | mardens | Mount David | gridiron | the Lewiston Public Library"
Presque Isle: "Governor's Restaurant | Riverside Park | Catholic Charities Thrift Store | The J. Paul & Blanche Levesque Imaging Center at The Aroostook Medical Center | Steaks N Stuff"
Ann Arbor: "VA Ann Arbor Healthcare System | University of Michigan Kellogg Eye Center | Busch's Fresh Food Market | Joe's Pizza NYC | Wide World Sports Center"
Kalamazoo: "the Bronson Pediatric Cardiology - Kalamazoo | The Old Goat Tavern | Family Health Center | Sweetwater's Donut Mill | One Well Brewing"
Muskegon: "Pere Marquette Park Beach | Northway Lanes | Ryke's | Mr. Quick | Mr. B's Pancake House"
Flint: "Donna's Donuts | Krystal Joe's Diner | Captain Coty's | Westside Diner | Big John's Steak & Onion"
Grand Rapids: "Van Andel Arena | Frederik Meijer Gardens & Sculpture Park | John Ball Park | the John Ball Zoo | Riverside Park"
Pontiac: "Carnival Market | Owen Elementary School | Michigan Animal Rescue League | Leone's Frosty Treat | Avon Donuts"
Cadillac: "Munson Healthcare Cadillac Hospital | G & D Pizza & Party Store | The Pines Sports Bar & Bowling Center | Cheryl's Landing | Clam Lake Beer Company"
Traverse City: "Clinch Park | Sue's J & S Hamburg | Oleson's | Family Fare Supermarket | Tom's Food Market"
Petoskey: "Kilwins Chocolate Kitchen | Independence Village of Petoskey | the Petoskey District Library | the Petoskey Waterfront | Southwoods Pub And Grill"
Escanaba: "Elmer's County Market | Gordon Food Service | Ludington Park | Osf St Francis Hospital | Drifter's"
Marquette: "Presque Isle Park | Lions Field | Thomas Theatre Marquette | Marquette Tourist Park | Marquette Mountain"
Hancock: "La Cantina Mexican Restaurant of Hancock | Gino's Restaurant & Cocktail Lounge | the Portage Lake Lift Bridge | Nisu Bakery & Cafe | Monte Carlo"
Wrangell: "Muskeg Meadows Golf Course"
Hoonah: "Hoonah Treasures | Hoonah Elementary School | Icy Stright Brewing | Oso Gordito | Hoonah High School"
Atka: "Uğurlu Balık"
Nikolski: "Nikolskiy, Umnak, Alaska | Fox's Son Co"
False Pass: "Isanotski Store | Trident Seafoods - False Pass | Galley - Trident Seafoods | Sheet Pile Dock | Dunkin"
Kivalina: "The G6"
Pilot Point: "the fishing camp | the hunting camp"
Chignik: "the fishing camp | the hunting camp"
King Salmon: "King Ko Inn | Sockeye Saloon | Alaska Commercial Company | Koselig Fishing Charters | Chinook Gift Shop"
Quinhagak: "Quinhagak"
Kotlit: "Tikahtnu Commons | Little Millers | Glacier Bay | Mendenhall Glacier | The Pump House"
Unalakleet: "Pullman | The Igloo | Peace on earth | Unalakleet Police Department | the Nome Community Baptist Church"
Koyuk: "Koyuk Native Store | the Koyuk Library | Koyuk School"
McGrath: "McGrath Airport | the McGrath Community Library | Susie's Cafe | Warnie | Joes Bar"
Hughes: "Hughes"
Ambler: "Ambler Airport | the mine"
Wales: "Kingikmiut School | Rice and Spam"
Kotzebue: "Maniilaq Health Center | AC Value Center | Northwest Arctic Heritage Center | Nullagvik Restaurant | Kotzebue middle And High School"
Wasilla: "Alaska Industrial Hardware | The Metro Cafe | the Sacred Heart Church | Menard Memorial Sports Center | Chepo’s Mexican Restaurant"
Circle: "Circle"
Denali Park: "Tikahtnu Commons | Little Millers | Glacier Bay | Mendenhall Glacier | The Pump House"
Yakutat: "Leonards Landing Lodge | Yakutat Lodge | Glacier Bear Lodge | shalehna | yakutat, ak"
Homer: "Save-U-More | Cole’s Market | Bishop's Beach | West Homer Elementary School | River Cafe"
Tanacross: "the village | the air strip"
Wiseman: "Wiseman, AK | Aurora Cabin | Wiseman"
Les Cayes: "Eau Secours | Cathédrale des Cayes | Hopital Immaculée Conception Des Cayes | Hot Spot | Timo Centre De Distribution"
San Quintin: "Ministerio Público SQ | Tacos Los Poblanos | Valentina Cafe Restaurante | Restaurant Misión Santa Isabel | Oxxo -Gasolinera Eco- SQ"
Punta Prieta: "Punta Prieta"
San Felipe: "Calimax | Los Arcos | El Rincon De Elena | Rockodile | San Felipe B.C Beach"
Santa Rosalia: "Fundicion; Santa Rosalia | Casa Ley Santa Rosalía | Tacos el paisano | Panaderia "El Boleo" | Tonka's Grill"
Guerrero Negro: "Chileno Bay | Empanaditas Gela de Cócorit | San Carlos Country Club | Marina Cabo San Lucas | The Arch of Cabo San Lucas (El Arco de Cabo San Lucas)"
Piedras Negras: "Gutierrez | Gutierrez Plaza | Tierra Santa | Unidad deportiva | Laboratorios Valdes"
San Pedro de las Colonias: "INP "Principe de paz | Mercado Juarez | Soriana Mercado | Plaza Principal | La Estancia"
Sierra Mojada: "Sierra Mojada"
Parras: "Vinicola Parvada | Plaza del Reloj | Bar la JAF | El Mesón de Don Evaristo | Rancho Buena Fe"
Nuevo Casas Grandes: "Mercado Soriana Casas Grandes | Expo Feria Nuevo Casas Grandes | Las Palmas Steak Tacos | OXXO - Dublán | Cockteleria Miramar"
Ojinaga: "AlSuper | Pizzería La Sierra | Los Comales | Tacos Sonora | Okinawa, Shiwawa."
Villa Ahumada: "Villahumada | Burritos de Carrito Villa Ahumada | Lo típico de Villa Ahumada | Restaurant Oscar's | Arizona Restaurant"
Santa Barbara: "Santa Barbara | papeleria arely | Gorditas Dona Pancha | Garden Salads & Beer | La Bomba"
Ciudad Camargo: "Parque Lineal, Segunda Etapa | Presidencia Mpal. Camargo | Soporte Tecnico Camargo | MoJo Peluqueria | Los Estribos"
Cuencame: "Plaza Principal | La Concha | Modelorama | Menudo el "Zancas" | Ayuntamiento Municipal"
Escuinapa: "Casa Ley | restaurante el caracol | Mercado De Hidalgo | AUS | Da Brothers Burguers"
Guamuchil: "Little Caesars Pizza | Los Olivos Aguachiles Y Callos | Jugos y Licuados Ponce | Bodega Aurrera | Ley Plaza del Evora"
Guasave: "Plaza Las Fuentes | El Tanque, Cabeza | Wings & Beer | Birrieria Valencia | Cenaduria Las Tostadotas"
El Fuerte: "Museo de El Fuerte | Restaurante “La Texana” | La cantina del zorro | Iglesia "Sagrado Corazón de Jesús" | Oxxo El Fuerte"
Eldorado: "Taquería El Pirri | Templo Sagrado Corazón de Jesús | Ley El Dorado | Farmacias Guadalajara | La Negra"
La Cruz: "Restaurante Hnos Carrillo | La Casona | Iglesia nuestra Sra Gpe | Cruz Gomez Silvia | Tortilleria Y Panaderia Esmeralda"
Agua Prieta: "Super Suárez | Bonitas Restaurante | Aguaprieta Sonora | Bonanza's | Unidad de Control Sanitario Agua Prieta"
Ciudad Obregon: "Carnes Clasificadas Chihuahua | Cahuamanta Las Palmas | Mariscos El Rey | Panadería Claudia | Plaza Tutuli"
Navajoa: "San Carlos Country Club | Empanaditas Gela de Cócorit | Álamos Sonora, Pueblo Magico | Circle S Saloon | Los Lagos"
Caborca: "Restaurant Dueñas | Ley Caborca | templo guadalupano | El Timon | soriana"
Mazatlán: "Restaurant Loma Linda | Mazatan | Puesto Doña Ivis | Centro De Salud"
Cananea: 
Huatabampo: "birrieria don armando 2 | 1950 | Ley | Oxxo Mayitos | Los Álamos Café"
Zacatecas: "Plaza Bicentenario | Alameda Trinidad García de la Cadena | Portal de Rosales | Bar Quinta Real | Mina El Edén"
Juan Aldama: "Bodega Aurrerá | Plaza de Juan Aldama | Pollo Feliz | La Sanjuanera Terraza | Super Obregon"
Valparaiso: "Puente Arroyo Atotonilco | Panaderia Santa Cruz | Plaza Principal Valparaiso | Mercado Valparaíso | paraiso restaurant"
Fresnillo: "Autoservicio El Papalote | OXXO Salida Valparaiso | Agora Jose Gonzalez Echeverria | Auditorio nacional Silviano Carrillo SJS | Portal Fresnillo"
Linares: "La Mision Supermercado | Plaza Juarez | Ferreteria Llavedares | Oxxo Gas | Taqueria Jorge"
Matehuala: "Tortas Las Sevillanas | Arco Sur | Parque Del Pueblo | Walmart Matehuala (Arboledas) | Coppel Madero"
Tamuin: "Parque Media Luna | Estadio Municipal de Tamuín | Jugos El Arbolito | Maria Bonita | Mercado de Tamuín"
Tamazunchale: "El Rinconcito | La Fogata De Don Eligio | Rio Moctezuma, Tamazunchale S. L. P. | Plaza de Tamazunchale | Restaurante El Huasteco"
Tula: "Presidencia Municipal de Tula | FOOD TRUCK LOS GORDOS | Terraza san Antonio | Hacienda del Estado, Tula, Tamaulipas. | Hospital Regional De Especialidades Tula"
Aldama: "Restaurant Super Cream | Universidad Del Atlantico | Restaurante El Amigo Chon | Gimnasio Municipal Aldama | Restaurante " El 7 Mares""
San Fernando: "Wide Open Outfitters | Mariscos La Gringa | Bodega Aurrera | Mariscos "El Velero" San Fernando, Tamps | "El Papas""
Tecoman: "Mercado Cuauhtémoc | Tacos El Buen Sabor | El Torito Pillín | Tostadas Doña Yoli | Mariscos Homero"
Puerto Vallarta: "El Caballito | La Isla Shopping Village | Los Arcos (Teatro al Aire Libre Aquiles Serdán) | La Comer | Elforoteo"
La Barca: "Plaza LA BARCA JAL. | Iglesia de san juan bosco | Lety y Chela Cenaduria | Birria El Barril | Birriería Miguel"
Ciudad Guzman: "Mariscos Puerto Vallarta | Mercado Paulino Navarro | Las Peñas | PM Bar y Picaduría | Tianguis Municipal"
Lagos de Moreno: "Portal Lagos | Farmacias Guadalajara (Suc. Salvador Camarena) | Tacos Don Alfred | Helados Bolonia | Tacos Ivan"
Morelia: "Espacio Las Américas | Casa de la Cultura | Mr. Hot Burrito | Mercado de Dulces | Pura Vida Morelia"
Lazaro Cardenas: "hamburguesas al carbon "El Yogui | Mercado Cuauhtémoc | Pollo Feliz Melchor Ocampo | Micheladas "Tariacuri" | Caffeto"
Zamora: "Plaza Ana | CT Telmex | Plaza Las Palomas | Mercado Hidalgo | La Casita"
Coalcoman: "Jardin De Coalcoman | Restaurant El Palmar | Cedars-Sinai Medical Center campus COALCOMAN | IMSS Coalcomán | Mariscos El Compadre"
Uruapan: "Centro Histórico Uruapan | Caltzontzin | Mega Comercial Mexicana | Plaza Ágora | Unidad Deportiva Hnos López Rayon"
Tuxpan: "Dr Rogelio Arciniega | Cocoroloco bar | Estadio De Beis Bol Lorenzo López Ibañez | La Vitamina | Centro De Maestros"
Tepic: "Centro Medico Puerta de Hierro | Hacienda La Higuera | Forum Tepic | Cerro De San Juan | Restaurant Vegetariano Quetzalcoatl"
Compostela: "Raspados "El Manantial" | Ley Express | Mariscos Barrabas | Restaurante "El Chivo De Oro" | La Choperia Compostela"
Tecuala: "mercado municipal de Tecuala | Cenaduria Luz | Centro Botanedo  "El dorado" | Plaza Principal | Presidencia Municipal de Tecuala"
Ciudad del Carmen: "Plaza Zentralia | Unidad Deportiva Maderas | Hot Dogs "Chendo" | Tacolandia | Taqueria "chico che""
Champoton: "Parque Costero Champotón | The Italian Coffee Company | Crunch Chicken | Taco Fish | Teatro de la ciudad"
Salina Cruz: "Antojitos Dobladas y Gorditas | DaVinci's | La Diabla | Mirador de Playa Abierta | Macao (Desde 1990)"
Puerto Escondido: "El Cafecito | Playa Principal | Playa Puerto Angelito | Adoquin | Mercado Benito Juárez"
Pochutla: "Vidita Negra Café | Zócalo Pochutla | Oxxo Pochutla | Chedraui Pochutla | Catedral de Pochutla"
Mitla: "Zona Arqueológica Mitla | Templo de San Pablo Apostol | Restaurante Donaji | La Choza del Chef | Zócalo"
Tlaxiaco: "Centro Histórico | Caldos de Gallina El Mixteco | Muebles Adecari | La Cocina De Casa | Parque Central General Porfirio Diaz"
Huajuapan de Leon: "Soriana | Mercado Zaragoza | Italian Atlantic Pizza | Cinemas Henry | Mercado Porfirio Díaz"
Tehuacan: "Centro Comercial El Paseo. | Mueganos El Águila Real de Tehuacán | Parque Arcadia | Helados Rosita | La Granja"
Teziutlan: "Tortas Tacos Y Gringas Doña Glo | Las Limpiecitas | La Fogata | Restaurante Cristina | Bodega Aurrera Teziutlan"
Frontera: "Mi Bodega Aurrera | Puerto de Frontera | frontera | El Cevichon | Soriana"
Tenosique: "Taco Felix | D' Manolo's pizzas | La Michoacana | Malecón | Parque Usumacinta"
Salamanca: "Cipreses Residencial | Mercado Tomasa Estevez | Tony´s | The Home Depot Salamanca | Walmart Jardines Del Country"
Guanajuato: "Monumento a El Pípila | Glorieta monumento a Cervantes | Mercado Miguel Hidalgo | Jardín Embajadoras | Casa Valadez Anfitrión & Gourmet"
Taxco: "Exconvento | Zocalo De Taxco | Centro Cultural Taxco Casa Borda | Súper Che | Plazuela La Garita"
Ayutla: "Asadero Libra | La telareña | House Party | Aquaman | Telecom Telegrafos"
Ciudad Altamirano: "Bodega Aurrera | Mercado Municipal Cd. Altamirano | Mercado del Oro | Catedral de Fray Juan Bautista Moya de Ciudad Altamirano | Free Way"
Petatlan: "Iglesia Del Santo Señor De Petatlan | Yardas Pizza | Mercado Isidro Montes de Oca | Fonda Doña Vicky | Muebleria Petatlan"
Pachuca: "Chaluperia Pruebe Papa | Escuela Americana de Pachuca A.C | Chedraui | Reloj Monumental de Pachuca | Parque Cultural Hidalguense Ben Gurión"
Toluca: "Patio Toluca | Estadio Nemesio Diez | Capultitlan Centro | Parque Alameda 2000 | Cosmovitral (Jardín Botánico)"
Zumpango: "Casa De La Cultura | Italians Pizza | san pedro de la laguna | Instituto Municipal De Cultura Física Y deporte De Zumpango | Mercado De Los Insurgentes"
Minatitlan: "Central De Abastos Minatitlan | Farmacia Guadalajara | Mariscos El Jarocho | Parque Independencia | Boxito Minatitlan"
Coatzacoalcos: "Mercado Popular Morelos | Bama de Lazaro Cardenas | Las Escolleras | Fabricas De Francia | Alameda"
Poza Rica de Hidalgo: "Oxxo Naranjos | Chedraui | Panaderia Los Tampiqueños | Restaurante Toks | Asadero Campinas"
Cordoba: "Office Depot | Plaza Crystal | Calufe Cafetos | OXXO Sinfonola | Chedraui"
Santiago Tuxtla: "La Enamorada Restaurante & Lounge | La Parroquia panderia | Pizzas Angelotti | Flor De La Canela | Las chicas"
Tuxpam: "Sam's Club | La Parroquia de Veracruz Tuxpan | Chedrahui | Infonavit Tenechaco | El T Bone"
Panuco: "Mr. Pizza | Malecón | Asociacion Ganadera Local | OXXO Burocrata | Gorditas Doña Lupita"
Pijijiapan: "Refugio del Sol Hotel & Club de Playa | soriana expres | Miramar | Río Pijijiapan | Iglesia Santa Rita de Casia"
Isla Mujeres: "La Playita Isla Mujeres | Playa Norte | Punta Sur | Chedraui | Coco Restaurant And Beach Bar"
Felipe Carrillo Puerto: "Plaza principal | Parque La Colmena | Snackbar "El Ruedo" | Panadería San Juán | OXXO Milano"
Tizimin: "Parque Zoológico De La Reina | Mercado de Tizimín | Casa Makech | Bodega Aurrera | Los Delfines"
Valladolid: "Centro Histórico de Valladolid | Casona Valladolid | Mercado Municipal Donato Bates Herrera | Las Campanas | Plaza Bella"
Izamal: "Convento de San Antonio de Padua | Zona Arqueológica KINICH-KAKMO | Restaurante Kinich | Parque Central Izamal Yucatan | Restaurant Café "Los Arcos""
Ticul: "Mercado de Ticul | Parroquia San Antonio De Padua | El Principe Tutul-Xiu | H. Ayuntamiento de Ticul | Iglesia de Ticul"
Cienfuegos: "Paladar Aché | Palacio del Valle | Malecón | Parque José Martí | Drake Club"
Sancti Spiritus: "boulebard de sancti spiritus | Parque Serafin Sanchez | Meson De La Plaza | La Guaybera Casa Museo | La Parrilla"
Moron: "Parque Marti | Las Ruedas | Rey Gallo | Confraria Das Quinta"
Nuevitas: "Ciringito Restaurant Cafe"
Manzanillo: "Glorieta Manzanillo | Dinos Pizza | Parque Valle Esping | Bulevar Manzanillo | Casa De Abuela"
Bayamo: "Plaza de la Revolucion | Restaurants Manegua | La Cuchipapa"
Las Tunas: "Parque 26 de Julio"
San Pedro de Macoris: "Hospital Regional Dr. Antonio Musa | Marbella | Oregano @ Emotions by Hodelpa | Oficinas Gubernamentales | Pasteles Amable"
Artemisa: "Plaza de la Revolución | Plaza de Armas | Plaza de San Francisco | Plaza de la Catedral | Parque Lennon"
Matanzas: "Plaza de La vigia | Hotel Velasco | Museo Farmaceutico | Bistró Kuba Bar Restaurante | Bukan"
Monte Cristi: "Supermercado Lilo | Malecon | Parque Duarte - Parque del Reloj | Grupo Medico Carlos J Finlay | Catedral Monte Cristi"
Barahona: "Malecon, Barahona | Panaderia, Panetis, Barahona | Hospital Regional Universitario Jaime Mota | La Fábrica | Las Rocas"
Bavaro: "Miramar | Dolphin Island | La Brisa | Strikers Sports Bar | Gran Teatro Bávaro"
Steinbach: "Walmart Supercentre | Barburrito | Sunshine Gardens & Greenhouse | Chinos Bistro | MJ's Kafe"
Nelson House: "Nelson House Education Authority | Nelson House Medicine Lodge | Nisichawayasihk Gaming Centre | NCN Family & Community Wellness Centre | Nelson House Fisherman's Association"
Shamattawa: "the St John's Anglican Church | Shamattawa First Nation Home Community Care Program | Building Healthy Communities | Shamattawa First Nation Public | Shamattawa First Nation"
Oxford House: "1972 Memorial High"
Yorkton: "Yorkton Regional High School | Chalet | the Tower Theatre | Tapps | Dollarama"
Swift Current: "Fairview school | Great Plains College - Swift Current Campus | Nightjar Diner Co. | Cypress Regional Hospital | Living Sky Casino"
Biggar: "Elmer Garage | Snow White Family Restaurant | Biggar Hospital | Hannigan's | Royal Canadian Legion"
Kindersley: "CO-OP Grocery | Kindersley Chiropractic Office | Western Pizza | The Liquor Store | Supreme Source For Sports"
Meadow Lake: "Meadow Lake Coop | The Bear's Den | Meadow Lake Golf Club | Northwest Health Facility | Eatery On Main"
Hudson Bay: "Railway Pub | Hudson Bay Composite High School | Hudson Bay Curling Club | the Hudson Bay Community Theater | Hudson Bay Elks & Royal Purple Lodge"
Lethbridge: "Real Canadian Superstore | Chinook Regional Hospital | Enmax Center | Nicolas Sheran Ice Arena | Cora"
Brooks: "Piston Broke Brewing | Centennial Arena | Canadian Beaver Brewing & Distillery Company | nikko sushi | the Oasis Theatre"
Lake Louise: "Lake Louise | Lake Louise Ski Area & Mountain Resort | Lake Louise Trail | Glacier Express Quad | Mt. Norquay"
Athabasca: "Athabasca River Front | Athabasca Burger Bar | Happy Garden Restaurant | Johnny's Eatery | Neighbours Pub"
Fort Chipewyan: "Kim mahs | Archie Simpson Arena | Fort Chipewyan | Northern Store | Northmart - NWC"
Bella Bella: "Gvákva’áus Haíłzaqv (House Of The Heiltsuk) | Waglisla Liquor Agency | Bella Bella Band Store Ltd | Bella Bella Fisheries Ltd | R W Large Memorial Hospital"
Sandspit: "The Clubhouse Restaurant | Willows Golf Course | Super Valu | Sandspit Medical Clinic | Javas on the Spit"
Campbell River: "Beach Fire Brewing & Nosh House | Elk Falls Provincial Park | Wasabiya | Session Bistro & Spin Room | More Eatery"
Port Hardy: "Café Guido | Save On Foods | Tsulquate Park | Seto's Wok & Grill Restaurant | Storys Beach"
Nanaimo: "Country Grocer | Nanaimo Regional General Hospital | Thrifty Foods | Smokin' George's BBQ | Value Village"
Quesnel: "Coffeehouse @ The Washboard | The Mill Pub | Lebourdais Park | Barkerville Brewing Co. | Granville's"
Abbotsford: "Highstreet | Abbotsford Centre | Field House Brewing Co. | Oldhand Coffee | Little Japan"
Dawson Creek: "Northern Lights RV Park | Rockwell's | Chilli'z Fried Chicken And Cantina | Orion Restaurant | Dollarama"
Penticton: "Barley Mill Pub | Okanagan Beach | Quality Greens | South Okanagan Events Centre | Peach-On-The-Beach"
Nelson: "Lakeside Park | Kootenay Co-op Grocery | Empire Coffee | Oso Negro café | Jacksons Hole Bar and Grill"
Lillooet: "Buy-Low Foods | Lilooet Gospel Chapel | Lillooet Brewing Company | Tim Hortons | Abundance Artisan Bakery"
Powell River: "Serious Coffee | River City Coffee | Tla'amin Convenience Store | Townsite Brewing | Julie's Airport Market"
Revelstoke: "Save-On-Foods | Little Spoon | the Revelstoke Suspension Bridge | Mount Revelstoke National Park | Mt. Begbie Brewing Co."
Burns Lake: "The Office | Boer Mountain Coffee House | Wholesale Club | Sunshine Inn - Burns Lake | lake babine band office"
Dease Lake: "Northway Motor Inn | Super A Foodsr | rumors | Pharmasave Telepharmacy | Royal Canadian Mounted Police"
Baker Lake: "Pizza Hut | Tim Hortons | Northern Convenience"
Norman Wells: "The North West Company | the Normal Wells Museum | Ventures Restaurant | Canol Lounge | Riverview Stationary & Supplies"
Fort McPherson: "Northern Store | Big Momma’s | Fort McPherson | the St. Matthew's Anglican Church | RCMP"
Burwash Landing: "Burwash Landing"
Orangeville: "Dave's Butcher Shop | Zehrs | Alder Street Rec Center | LCBO | Orangeville Police Service"
Little Current: "Elliott's | Manitoulin Brewing Company | Orr's valu-mart | Farquhar's | Loco Beanz"
Chapleau: "Chapleau valu-mart | The Bargain! Shop | Chapleau Hub | Miss Muggins Coffee N Donuts | Dominion Family Restaurant"
Wawa: "John's Your Independent Grocer | Makade Nimkii Convenience Store | Wawa General Store | North of 17 | Wawa Lake"
Hearst: "Pizza Place | John's Restaurant | Your Independent Grocer | Moose & Wolves | Husky House Restaurant"
Marathon: "Tim Hortons | Marathon Centre Mall | The Bargain Shop | Your Independent Grocer | Wok with Chow"
Sioux Lookout: "Forest Inn Dining Room and Lounge | LCBO | Forest Inn | Pelican Lake Residential School | Frog Rapids Camp"
Red Lake: "Antonio's | LCBO | Howey Bay Restaurant | Ice Shack on Gull Rock | LAKESIDE MARINA LTD."
Cat Lake: "Cat Lake"
Cornwall: "Benson Centre | LCBO | Hops & Barley Restaurant & Lounge | Bulk Barn | Kelseys Original Roadhouse"
Kingston: "Frontenac Mall | LCBO | Value Village | coffee way | Dollarama"
Barrie: "the Bradford Greenhouses Garden Gallery | RioCan Georgian Mall | Barrie Country Club | Bayfield Mall | Zehrs"
Parry Sound: "Bobby Orr Community Centre | Popeyes Louisiana Kitchen | Parry Sound Mall | Parry Sound Salt Dock (Smelter Wharf) | Waubano Beach"
Wiarton: "Bluewater Park | Lost Art Espresso | Frosty Freeze | Wiarton Hospital | Ashanti Cafe"
Cobalt: "Urban Market & Eatery | Miner's Tavern | Laura's Art Shoppe | Cobalt, Ont | Adroit Resources Inc"
Cochrane: "Lady Minto Hospital | Your Independent Grocer | Ice Hut | The Station Inn Resturant | Giant Tiger Cochrane"
Nipigon: "Nipigon Lookout | Love, Cpffee | The Bargain! Shop | Nipigon River Twin Bridges | The Dock At The Lake"
Atikokan: "Foodland | Museum Of Atikokan | Pinewood, ON | Atikokan Old Ski Hill | The Outdoorsman"
Rimouski: "Colisée Financière Sun Life | Marché public de Rimouski | Parc Beauséjour | Restaurant Haute Ville | Dollorama"
Saint-Georges: "Restaurant Chez Gérard | Les Halles Des Pères Nature | Centre sportif Lacroix Dutil | Rock Cafe | Parc Des 7 Chutes"
Victoriaville: "Fromagerie Victoria | Restaurant Max Poutine | Le Victorin | chic choco-latté | Parc Terre Des Jeunes"
Chevery: "Netagamiou School | SAQ Agence - Dépanneur Bellecourt enr."
Mistassini: "Resto des Copains | Parc de la Pointe des Pères (Société de gestion environnementale) | Maxi | salaison Besson | Le Roi du Chien Chaud"
Kangirsuk: "kangirsuk hospital"
Shawinigan: "Fromagerie Victoria | Marché Public de Shawinigan | Aubainerie | Place Biermans | Centre Gervais Auto"
Matagami: "Poulet Fritou | Cabane A Sel | Dépanne-Nord Beau-Soir | Resto L'imprévu | Club de Golf Matagami"
Mont-Laurier: "Paroisse cathédrale Notre-Dame-de-Fourvière | La Crémière | Plaza Paquette | La Chaumière | Boston Pizza"
Pembroke: "Fontaine De Venise | thorne | Algonquin | Euphoria Smoothie Cafe Royal | IgA"
Radisson: "Esso Radisson | Sentier Écologique | Gros Tas De Roches | Ville de Radisson (Grand Nord québécois) | Bar Boreal"
Saint John: "Mclarens Beach | Real Atlantic Superstore | Millidgeville Market Superstore | Rockwood Park | Carleton Martello Tower"
Edmundston: "Dollarama | Brasseurs du Petit-Sault Brewers | Fiddlehead | Pizza Delight / Scores | Mont Farlagne"
Shelburne: "Boxing Rock Brewing | Roseway Hospital | Upper Sandy Point Cemetery | Shelburne Mall | Emerald Light"
Antigonish: "Charles V. Keating Millennium Centre | Atlantic Superstore | Cleve's Source For Sports | Justamere Cafe | Gabrieau's Bistro"
Windsor: "Hants Community Hospital | Magic Pizza | Bedard Bakery | Gerrish & Gray | Schoolhouse Brewery"
Digby: "Real Atlantic Superstore | Walmart | Josie's Place | Tacocat | Digby Hospital"
Stephenville: "The Bar | Hartery's Family Restaurant | Domino Pizza Place | Dollarama | M P Judy Foote"
St. Anthony: "Ragnarock Northern Brewing | Fox Point Lighthouse | Fishing Point Emporium | The Lightkeepers | Water Bomber"
Channel-Port aux Basques: "Foodland | Grand Bay West Trail | Channel Head Lighthouse | Grand Bay Mall | St. James Church & Memorial Centre"
Buchans: "Buchaneer Lounge | Canadian Post | Colemans Grocery | Rick Noftle"
Trout River: "Seaside Restaurant | Trout River Campground | Green Gardens Trail | Canadian Post | Hanns Confectionary"
Churchill Falls: "Midway Restaurant | Churchill Falls Dental Clinic | Stricklands Convenience Store | Canadian Post | Department Store Basement"
Forteau: "Sea View Restaurant | Red Rocks Pub | Canadian Post | Krown Rust Control | Has Grocery & Hardware"
Ponce: "Plaza del Caribe | Econo | Ponce Town Center | Food Court | Plaza del Caribe | Ponce Mall"
Mayaguez: "Ricomini | El Mesón Sandwiches | Mandarin | Ricomini Bakery | Pueblo"
La Romana: "Playa Minitas | Minitas Beach Club & Restaurante | Boulevard de la Romana | Whelhams | Altos de Chavon"
Trepassey: "First Venture Family Restaueant"
Kailua-Kona: "Kona Commons Shopping Center | Kona Coast Shopping Center | Coconut Grove Marketplace | KTA Super Stores | Honokohau Harbor"
Butte: "the Gold Hill Lutheran Church | Western Meat Block | Granite Mountain Memorial | Three Bears Alaska | East Side Athletic Club"
Grand Forks: "Columbia Mall | Hugo's | the Grand Forks Public Library | Happy Harry's Bottle Shop | Paradiso Mexican Restaurant"
Pocatello: "Juniper Hills Country Club | Ward Park | Deseret Industries | Ridley's Market Place | Bannock County Drivers License"
Tacoma: "Metropolitan Market Tacoma | the Point Defiance Zoo & Aquarium | Clear Choice Cannabis | Browns Point Lighthouse Park | Cheney Stadium"
Yuma: "Yuma Regional Medical Center Administration Building | Yuma Palms Regional Center | West Wetlands Park | Joe Henry Park | Arizona Market Place"
Prescott: "Bucky's Casino | Prescott Gateway Mall | Yavapai Casino | Picture Show | Sportsman's Warehouse"
Long Beach: "LBX | Aquarium of the Pacific | Queen Mary Events Park | Shoreline Park | Alamitos Beach"
Grand Junction: "Freeway Bowl | Los Jilbertos | St. Mary's Hospital & Regional Medical Center | Canyon View Park | Rib City - Grand Junction"
Ely: "Prospector Hotel Ely (Nevada) | Ridley Family Market | Beans & Brews Coffeehouse | Shooters Bar | Flower Basket Espresso"
Carson City: "The Lady Tamale | Bodines Casino & Restaurant | Casino Fandango | The Carson Nugget | The Grille (Gold Dust West)"
Carlsbad: "Carlsbad Beach Park | Juicy Peach Espresso | Milton's Brewing | Red Chimney Pit Bar-B-Q | Yellow Brix Restaurant"
Alamogordo: "DOLLAR GENERAL | Lowe's | Briggs Field Doggy Park | Plateau Espresso | Desert Lakes Golf Course"
Medford: "Sherm’s Food 4 Less | Rogue Valley Mall | El Molcajete | Sherm's Thunderbird Market | North Medford High School"
Klamath Falls: "Epicenter | North Shore Hawaiian Plate Lunch | The Chicken Shack | Thunderbird Market | A Leap of Taste"
St. George: "Red Cliffs Mall | Harmons Grocery | Deseret Industries | Sullivan Virgin River Soccer Park | Dixie Rock"
Provo: "Provo River Parkway | Peaks Ice Arena | BYU Creamery on Ninth | Street Tacos Don Joaquin | The Shops at Riverwoods"
Laramie: "Cavalryman Steakhouse | Corona Village | Murdoch's Ranch & Home Supply | North Ridge Discount Liquors | Washington Park"
Little Rock: "Outlets of Little Rock | Promenade at Chenal | Midtowne Shopping Center | the Little Rock Zoo | K. Hall and Sons Produce"
Wichita: "the Sedgwick County Zoo | Sedgwick County Park | Bradley Fair Shopping Center | OJ Watson Park | Taco Shop"
Jefferson City: "Schulte's | Missouri State Capitol | Prison Brews Brewery & Restaurant | West Main Pizza | Family Medical"
Rapid City: "Rushmore Crossing | Baken Park | Timmons Market | Boyds Drug Mart | Ice Arena"
Lafayette: "Billys Boudin and Cracklin | Kart Ranch | Buffet City Lafayette | Girard Park | Lagneaux's"
Galveston: "Galveston Island Historic Pleasure Pier | The Spot | San Luis Pass | Murdoch's | Arlan's Market"
Freeport: "Stripes | Talk About Good | Surfside Beach City Hall | Super S Foods | Belly’s On The Brazos"
Victoria: "Victoria Mall | Cimarron Express | Riverside Park | Mumphord's | Sports"
Odessa: "Market Street | Music City Mall | Dos Amigos | Zavala Elementary | Rosa's Cafe and Tortilla Factory"
Wichita Falls: "Braum’s Ice Cream & Dairy | Braum's Ice Cream & Dairy Stores | Lake Wichita Park | Don Jose Mexican Restaurant | El Mexicano Resturant & Cantin"
Waco: "Grace Gospel Campground | Central Texas Marketplace | Magnolia Market | Rosa's Cafe | SUB Food Court"
Lubbock: "Costco | Cagle Steaks | Stripes | Food King | the Stars & Stripes Drive-In Theatre"
Hartford: "Hartford's North End | Aqui Me Quedo | Parkville Market | Dunkin' Park | Jahm Ske's"
Providence: "Roger Williams Park | LEGO Store | Good Fortune Supermaket | East Side Pockets | Olneyville New York System Restaurant"
Birmingham: "The Summit | UAB Hospital | BJCC Concert Hall | Callahan Eye Foundation Hospital | Full Moon BBQ"
Mobile: "The Shoppes at Bel Air | Providence Hospital | Hart's Fried Chicken | Medal of Honor Park | Greater Gulf State Fairgrounds"
Pensacola: "Cordova Mall Food Court | McGuire's Irish Pub | Joe Patti's Seafood | Chow Tyme Grill & Buffet | Apple Market"
St. Petersburg: "Sawgrass Lake County Park | Vinoy Park | Sundial St. Pete | North Shore Park | Carmelita's Mexican Restaurant"
Biloxi: "Keesler Air Force Base | Veterans Hospital | Mississippi Coast Coliseum and Convention Center | Palace Buffet | Biloxi Beach"
Springfield: "Ritz's Lil' Fryer | Cozy Dog Drive In | Humphrey's Market | Star 66 Cafe | Long Bridge Golf Course"
Frankfort: "Buffalo Trace Distillery | China Buffet | Cook Out | the Capital City Christian Church | Lakeview Park"
Greensboro: "Greensboro Coliseum Complex | Cook-Out | K&W Cafeteria | Greensboro Science Center | Country Park"
Dayton: "George's Family Restaurant | National Museum of the US Air Force | Dayton Children's - Main Campus | Eastwood MetroPark & Lake | Marion's Piazza"
Virginia Beach: "Landstown Commons Shopping Center | Red Mill Commons | Mount Trashmore Park | Virginia Aquarium & Marine Science Center | Kempsville Rec Center"
Madison: "Hilldale Shopping Center | the Henry Vilas Zoo | Vitense Golfland | Metcalfe's Market | Olin-Turville Park"
Green Bay: "Lambeau Field | Green Bay Plaza | Resch Center | Packers Pro Shop | The Bar"
Trenton: "South Trenton Tunnel | Roebling Market | Cadwalader Park | CURE Insurance Arena | Trenton Farmers Market"
Lansing: "Eastwood Towne Center | Hawk Island County Park | Westgate Tavern | Flap Jack Restaurant | Twisters Ice Cream"
Gambell: "Alaska Commercial | Alaska | Trinsic, Sosaria | Gambell | Moonglow, Sosaria"
Palmer: "Reindeer Farm | Arkose Brewery | Noisy Goose Cafe | Pho and Thai Restaurant | Big Dipper Homemade Ice Cream"
Seward: "Safeway Pharmacy | Fourth of July Beach Resurrection Bay | Gypsea’s Treasure Trunk | Alaska Sea Life Center | Waterfront Campground"
Cap-Haitien: "Nouvo Restoran Vania Bon manje peyi | Léa Trading | Croissant d'or | State Records _ CAP Connection | Cap Deli"
Ensenada: "Explanada de la Bandera | Alfonso's Pizza | Mercado Negro | Papas & Beer Ensenada | Tacos de Pescado El Fenix"
Saltillo: "Parque Las Maravillas | Alsuper LaFragua | Mochomos | Galerías Saltillo | Estadio Francisco I. Madero"
Ciudad Juárez: "Starbucks Aeropuerto | Centro Histórico | Plaza de la Mexicanidad | Viva Mexico | El Toro Bronco"
Delicias: "Mercado Juárez | El Granero | Centro Dulcero Delicias | El Piano | Cinemas Delicias"
Durango: "Club Campestre de Durango | Mercado Fco. Gomez Palacio | Museo Bebeleche de Durango | Sam's Club | AlSuper Store"
Los Mochis: "Oxxo Jardines Del Bosque | Panamá Restaurante & Pastelería | Plaza Punto Mochis | Estadio Emilio Ibarra Almada | Lola Cocina de Mercado"
Ciudad Victoria: "Gorditas El Tigre | GranD Campestre | Gorditas La Especial | GranD Central | Cony's Soriana Tamatan"
Aguascalientes: "Centro Comercial Altaria | Club Campestre de Aguascalientes | Isla San Marcos | San Telmo Town Center | Plaza de Toros Monumental"
Manzanillo: "Plaza Manzanillo | El Agave | Comercial Mexicana | Soriana Hiper | Oasis Ocean Club"
Tehuantepec: "Centro Histórico de Santo Domingo Tehuantepec | Mercado Tehuantepec | Yizu Coffe spresso | Doña Nereida Garnachas | Parque Central Tehuantepec"
Villahermosa: "Plaza Altabrisa | Chedraui Selecto | Plaza Mallorca | Walmart Express | Apple Shop El Palacio de Hierro"
Cuernavaca: "Galerías Cuernavaca | Averanda Mall | Forum Cuernavaca | Petco Express | Parque Ecológico Chapultepec"
Queretaro: "Puerta La Victoria | Mercado La Cruz | Cervecera Hércules | Jardín de Cerveza Hercules | Plaza Constitución"
Tapachula: "Villa del Mar | Parque Central Miguel Hidalgo | Plaza Cibeles | Café & Deli Soconusco | Plaza Crystal"
Chetumal: "Malecon de Chetumal | La Explanada de la Bandera | Mercado Ignacio Manuel Altamirano | OK Bar Club | Multiplaza Chetumal"
Progreso: "Eladio's | Puerto Progreso | Mercado de Progreso | Malecón Internacional de Progreso | La Casa del Pastel"
Pinar del Rio: "Pınar Del Rio | Parque Roberto Amarán | Garden Cocktail Truck | Parque Independencia | El Parqueo"
Camaguey: "Plaza del Carmen | Plaza de los Trabajadores | Cafe Cuidad | Amarelo | Plaza San Juan de Dios"
Guantanamo: "Akdeniz Discorium | Сан Хусто"
Holguin: "Parque Calixto García | Loma de la Cruz (Hill of the Cross) | Iglesia San Jose | the Zoo | Bazar De Artesania"
Montego Bay: "Air Margaritaville | The Beach @ The RIU Hotel | Jamaican Bobsled Cafe | Rose Hall Restaurant | Barefoot Bar"
Santa Clara: "Monumento a la Toma del Tren Blindado | Che Guevara Mausoleum | Parque Vidal | Che Guevara's Monument | Casona Guevara"
Duluth: "Super One Foods | Mills Fleet Farm | Billy's | Canal Park | Country Lanes North"
Bemidji: "Lueken's Village Foods | Slim's Bar & Grill | L&M Fleet Supply | Mi Rancho | Gordon Falls Playground"
Havre: "Havre High School | IGA Havre | Rod's Drive In | Cottonwood cinema | Murphy's Pub"
Kalispell: "Super 1 Foods Kalispell | Sportsman & Ski Haus | Flathead High School | Rosauers | Copper Mountain Coffee"
Idaho Falls: "Civic Auditorium | Java Espress | Tautphaus Park | Cline Family & Cosmetic Dentistry | Mitchell's Restaurant"
Lewiston: "Rosauer's | The Bait Shop | Clearwater Canyon Cellars | El Sombrero Mexican Restaurant | Georgia Carpetworks"
Yakima: "Tieton Cider Works - Cider Bar | Fiesta Foods | Rosauers | Major's Burgers on 3rd | Backwoods Cafe"
Wenatchee: "Plaza Super Jet | Town Toyota Center | Aztec Burgers | Hooked On Toys | Walla Walla Point Park"
Douglas: "US Customs Border Check Point | DMV | Airport Park | El Chef | 333 Cafe"
Bakersfield: "Mercado Latino | Hart Park | Vallarta Supermarkets | Mariscos Las Islitas | Cope's Knotty Pine Cafe"
Oakland: "the Oakland Zoo | Jack London Square | Oakland Arena | Middle Harbor Shoreline Park | Rockridge Market Hall"
Lancaster: "Costco Food Court | Carbonara Food Truck | George Lane Park | Superior Grocers | Kaiser Permanente Lancaster Medical Offices"
Chico: "Down Range | Bidwell Park | Sutherland Lanscape Supply | Tower Market | the Madison Bear Garden"
Monterey: "Del Monte Shopping Center | the Monterey Bay Aquarium | Post Exchange | Dennis the Menace Park | Del Monte Beach"
Salinas: "Northridge Mall | Food Co | El Charrito | El Super | Alvarado Street Brewery and Tasting Room"
Los Alamos: "Hot Rocks Java Cafe | the Los Alamos History Museum | Los Alamos Teen Center | North Mesa Picnic Grounds | Cottonwood on the Greens"
Eugene: "Costco Food Court | St Vincent De Paul Superstore | the McDonald Theatre | Jerry's Home Improvement | Fern Ridge Bike Path"
Coos Bay: "Marshfield High School | Cranberry Sweets | Coach House | Atilano's Mexican Food | Human Bean"
Bend: "Cascade Village Shopping Center | Old Mill District | Pine Nursery Community Park | Pine Nursery Off Leash Park | Pilot Butte State Park"
Cody: "Brewgard's | Buffalo Bill Center of the West | Granny's Restaurant | Cody Stampede Nite Rodeo | Big Horn Cinemas"
Cedar Rapids: "the Cedar Rapids Public Library | Fareway | Noelridge Park | Tic Toc | Theisen's"
Springfield: "James River Church - West Campus | Wonders of Wildlife | Hyvee Liquor Dept. | Neighborhood Pizza Cafe | Prime Inc Cafe/Grill"
Lincoln: "SouthPointe Pavilions | Gateway Mall | Haymarket | Hy Vee Wine & Spirits | Shoemakers Truckers Dining"
Alexandria: "Outlaw's Barbecue | Walk-On's Sports Bistreaux | Mac's Fresh Market | Hokus Pokus Liquor - Alexandria | The Grand Theatre 16"
Abilene: "Market Street | Mall of Abilene | Lytle Land & Cattle Co. | Rosa's Cafe | Dixie Pig"
Brownsville: "Brownsville Sports Park | Flea market | Bigo's Bar & Grill | Galaxy Bowling Center | Centro de Especialidades Medico Quirurgicas"
Tyler: "FRESH by Brookshire's | Villa Montez | The Oil Palace | Walmart Neighborhood Market | Super 1 Foods"
Concord: "walmart connection center | Makris Lobster & Steak House | White Park | Memorial Building | Windmill Family Restaurant"
Huntsville: "Bridge Street Town Centre | U.S. Space and Rocket Center | Shaggy's Burgers and Tacos | Campus 805 | El Olmeca"
Key West: "Southernmost Point Buoy | Mallory Square | Fort Zachary Taylor Historic State Park | Sloppy Joe's Bar | The Waterfront Brewery"
West Palm Beach: "Village Commons | Rosemary Square | CACTI Park of the Palm Beaches | Kravis Center for the Performing Arts, Inc. | Elisabetta's Ristorante"
Sarasota: "Lido Beach | St. Armands Circle | Walt's Fish Market | Cat Depot | The Ringling Museum at The Florida State University"
Daytona Beach: "Daytona Flea & Farmers Market | Rolex 24 at Daytona | Daytona International Speedway Petty Tower | AdventHealth Radiation Oncology Daytona Beach | The Start / Finish Line"
Gainesville: "Butler Plaza | Celebration Pointe | Malcom Randall VA Medical Center (VAMC) | Spurrier’s Restaurant | 43rd Street Deli & Breakfast House"
Ft. Myers: "The Forum | Fleamasters Fleamarket | KJ's Steakhouse | Wings and Rings | JetBlue Park at Fenway South"
Brunswick: "Willie's Wee-Nee Wagon | Pho #1 | Tacos La Fiesta LLC | Twin Oaks BBQ | Wake Up Coffee Co."
Augusta: "Augusta Mall Food Court | Cook Out | Augusta National Golf Club | Fort Gordon Main Exchange | Georgia Cancer Center"
Vicksburg: "the U.S.S. Cairo Museum | VICK - Stop 11 - Great Redoubt | Solly's Hot Tamales | Boston Fish Supreme | Walnut Hills"
Myrtle Beach: "Broadway at the Beach | The Original Benjamin's Calabash Seafood | Manny's Deli & Subs | the Ripley's Aquarium | Asian Mart"
Charleston: "Ashley Landing | St. Andrews Center | Charleston City Market | Magnolia Plantation & Gardens | James Island County Park"
Peoria: "Glen Hollow Shopping Center | The Shoppes At Grand Prairie | Carver Arena | Methodist Medical Center of Illinois | the Peoria Civic Center Theatre"
Evansville: "Ford Center | Donut Bank Bakery & Coffee Shop | Crazy Buffet Chinese Restaurant | Kipplee's | Showplace East"
Louisville: "Churchill Downs | the Louisville Zoo | Cherokee Park | Broad Run Park | Bc Roosters"
Lexington: "Red Mile | Cook Out | Jacobson Park | Keeneland | Kentucky Horse Park"
Charlotte: "Carowinds | Spectrum Center | Camp North End | Shops At Blakeney | Freedom Park"
Youngstown: "Four Seasons Fleamarket And Produce | Uptown Pizza | Jimmy's Italian Bakery and Deli | Kravitz Delicatessen | Check n go"
Canton: "Smith's Waco Market | Aunt MaryAnn Donuts & Cafe | Mercy Medical Center | Tim's Tavern | Home Buys"
Toledo: "Franklin Park Mall | Wildwood Preserve Metropark | ProMedica Toledo Hospital | the Toledo Zoo | Huntington Center"
Columbus: "The Shops on Lane Avenue | Easton Town Center | Nationwide Arena | Roosters | Historic Crew Stadium"
Chattanooga: "McKay Used Books & CDs | the Tennessee Aquarium | Coolidge Park | Food City | Chickamauga Dam"
Charlottesville: "Barracks Road Shopping Center | Charlottesville Historic Downtown Mall | Bodo's Bagels | Timberwood Tap House | Higher Grounds"
Lynchburg: "Joe Beans | Cookout | E.C. Glass High School | Shakers Restaurant | Lynchburg Beer Cellar"
Wausau: "Crossroads County Market | Marathon Park | Loading Zone | Wausau Mine Company | Horace Mann Middle School"
Albany: "Crossgates Mall | MVP Arena | Food Court | Fidens Brewing Company | the New York State Museum"
Ithaca: "Dandy @ Rogan's Corner | GreenStar Cooperative Market | Temple of Zeus | Buttermilk Falls State Park | Cinemapolis"
Harrisburg: "Large Arena | City Island | Butter Sculpture | Wildwood Park | Reservoir Park"
Bangor: "Northern Light Eastern Maine Medical Center | Ocean State Job Lot | Webber Medical Building | Cross Insurance - Bangor | Happy China Buffet"
Portland: "The Great Lost Bear | Portland Food Co-op | Deering Oaks Park | Portland Public Library - Main Branch | Becky's Diner"
Saginaw: "Aleda E. Lutz VA Medical Center | Spatz | Baywood Lounge | Tony's Original Restaurants | Rico's Authentic Mexican Takeout"
Ketchikan: "The Plaza | Alaska Rainforest Sanctuary | Sourdough Bar | Airport Lounge & Snack Bar | Arctic Bar"
Unalaska: "Harbor View Bar & Grill | Aleutian Fresh Seafoods | The Norvegian Rat | Unisea Harborview Sports Bar | Coastal Dock"
Togiak: "gurme tobacco"
Hooper Bay: "Hooper Bay Airport | Alaska Commercial"
Wainwright: "Arctic Slope Native Association | Alak School"
Galena: "Alaska Commercial | Tamara Alice Huntington | Sidney C. Huntington School | Galena Health Clinic | Galena City School District"
Kaktovik: "Barter Island LRRS | Kaktovik City Recreation Department | Harold Kaveolook School | Teknoplus | Kaktovik Inupiat"
Skagway: "Alaska Commercial | Skagway River | Skagway Spirits Distillery | Grizzly Falls Ziplining Expedition | the Pat Moore Bridge"
Cordova: "AC Value Center | Laura's | Copper River Brewing | The Jump | USCG AVSUPFAC CORDOVA"
Kenai: "The Flats Bistro | Three Bears | Kenai Central High School | Kenai Beach | Paradisos Restaurant"
Brochet: "Awasisak-Kitchi Daycare Center | Brochet, Manitoba"
Lynn Lake: "Lynn Inn | Corner Pocket | Clarkes Health & Variety | Northwest Manitoba Community Futures Development Corp | Marcel Colomb First Nation"
Gillam: "Gillam Co-op Grocery Store | Gillam Rec Center | Julia's playhouse | Beirnes Livingroom | Gillam MTS"
North Battleford: "Co-op | Big Barrel Tavern | Gold Eagle Casino | Beaver Grill Express | Cutlett Express"
Prince Albert: "city hall | Prince Albert Brewing Company | St. Francis | Bison Cafe | Venice House Pizza 2 For 1"
Courtenay: "Thrifty Foods Pharmacy | The Old Farm Market | Tin Town Cafe | Rialto Theatres | Flying Canoe West Coast Pub"
Kelowna: "City Park | Orchard Park Shopping Centre | Prospera Place | Value Village | Hudson's Bay"
Pangnirtung: "Pangnirtung Haven | Pangnirtung"
Holman: "Canada Giveaway"
Dryden: "The Riverview Lodge | Patrica Inn | Dryden Regional Health Centre | LCBO | Dryden Arena"
Attawapiskat: "Pizza Hut | Northern Stores | I.D.A. | Ontario Works | Kattawapiskak Elementary School"
Hamilton: "Lime Ridge Mall | Fortinos | Zarky's | Gage Park | Lococo's"
Windsor: "Devonshire Mall | Zehrs | Multifood Supermarket | Dollarama | WFCU Centre"
Trois-Rivières: "Le Carrefour Trois-Rivières-Ouest | Banh thai | Buffet des Continents | Café Morgane | Parc de l'Île St-Quentin"
Sept-Îles: "Aréna Guy-Carbonneau | Museum Shaputuan | Aubainerie | Galeries Montagnaises | ITUM: Innu Takuaikan Uashat mak Mani-utenam"
Corner Brook: "Railway Society Of Newfoundland | Corner Brook Plaza | Louis Gee's Pizza & Donairs | Home Design | Jungle Jim's"
Cabo San Lucas: "Marina Cabo San Lucas | The Arch of Cabo San Lucas (El Arco de Cabo San Lucas) | The Office | Marina Mercado | Baja Brewing Company"
Monclova: "Super Gutierrez | Oxxo Santa Monica | Sam's Club | Pizza Rizza Sur | Purotaco"
Ometepec: "Zócalo Ometepec | Soriana | Súper Che | centro de ometepec | Restaurant Eclipse"
Cozumel: "Three Amigos Cozumel | Margaritaville | Punta Langosta | Fat Tuesday's | Parque Benito Juárez"
San Juan: "Puerto Rico Port Old San Juan | Distrito T-Mobile | Plaza del Mercado de Santurce | Plaza Colón | Escambron Beach"
Norway House: "York Boat Diner | Kinosao Sipi Multiplex"
Flin Flon: "Co Op Foods | Chicken Chef | Subway | Hudson bay mining | Whitney Arena"
Dauphin: "Ken's No Frills | Watson Art Centre | Credit Union Place | Dauphin Medical Centre | Countryfest Community Cinema"
The Pas: "Good Thymes | The Pas Flying Club | Miss The Pas Restaurant | Sammy Kowalchuk - Independent Scentsy Director | hospital"
Uranium City: "Uranium City | Parkes General Store | Uranium City, Saskatchewan | Ben McIntyre School | Northern Settlement of Uranium City"
Moose Jaw: "Mosaic Place | Bugsy's Irish Pub | Cowtown | Pla-Mor Palace | Montana's"
Jasper: "Marmot Basin | Lake Mildred | Upper Chalet | Robinson's AG Foods | Pyramid Island"
Red Deer: "Bower Ponds | Burger Boy | Westerner Park | Enmax Centrium | East Side Mario's Red Deer"
Banff: "Banff National Park | Bow Falls | Central Park | Banff Upper Hot Springs | Sulphur Mountain Summit"
Grand Prairie: "Avenue Eatery and Cafe | Cedars Bakery | Borealis Pet Centre | Benjamin Moore | Fort McMurray Animal Hospital"
Smithers: "Bulkley Valley Wholesale | Roadhouse Smithers | Riverside Campground | Smithers Brewing Co. | Bulkley Valley District Hospital"
Kamloops: "Aberdeen Mall | MacArthur Island | Riverside Park | Kamloops Sports Council | Kamloops Wildlife Park"
Williams Lake: "Cariboo Memorial Hospital | Sushi Sakura | Oliver Street Bar and Grill | Cadet Hall | Xin Tea"
Prince George: "Spruceland Mall | Pine Centre Mall | Westwood Pub | CN Centre | Moore's Meadow"
Fort Nelson: "Down To Earth Health Shop | Fort Nelson Camping | Triple G Hideaway | Boston Pizza | Fort Nelson Visitor Center"
Pond Inlet: "Tim Hortons"
Cape Dorset: "Scam-Inspect"
Gjoa Haven: "Gjoa Haven Muséum"
Grise Fiord: "Grise Fiore"
Alert: "Co-op | MacDonald Island Park | The Canadian Brewhouse | Javaroma | Northern Arts & Cultural Centre"
Rankin Inlet: "Singiittuq Complex Arena | Northern store | The Granite Room | Wild Wolf | TOROMONT INDUSTRIES, LTD."
Fort Resolution: "Deninu School Fort Resolution | Fort Resolution"
Fort Simpson: "pandaville | Ice Breaker | Northern Store | Fort Simpson Recreation Centre | Golf Course"
Inuvik: "NorthMart | The Roost | Moe's Stationary | Midnight Sun Recreation Complex | The Mad Trapper"
Tuktoyaktuk: "Arctic Ocean Sign | Pingo Canadian Landmark | Our Lady Of Lourdes Ship | Grandma's Kitchen | Pingo Canadian Landmark Viewpoint"
Watson Lake: "Sign Post Forest | Downtown RV Park | Nugget restaurant ltd | Tags | Historic Mile 635"
Lansdowne House: "Lansdowne House, Ontario | Neskantage Education Authority"
Moosonee: "Northern store | James Bay Assoc For Community Living | Sky Ranch Restaurant | Corporation of the Town of Moosonee | Town of Moosonee"
Sudbury: "Copper Cliff | Chris' Your Independent Grocer | Garson Arena | M.I.C. | Cambrian College"
Kenora: "Beauty Bay Park & Golf Course | Lake Of The Woods Brewing Company | A & W Root Beer | McMunn & Yates Building Supplies | Husky the musky in McLeod Park"
Gaspe: "Plage Haldimand | Pointe-à-la-Renommée | Place Jacques Cartier | Musée de la Gaspésie | Dixie Lee"
Mingan: "Pourvoirie du Lac Allard et Rivière Mingan Inc"
Val d'Or: "depanneur des hauts-bois | Polyvalente Le Carrefour | Café Du Lac | Clinique De Physiothérapie Val D'Or Inc | Depanneur Tramblay"
Ivugivik: "Bedondaine & Bedons Ronds | Parc Jean-Drapeau | Mont Orford | Parc Omega | Parc de l'Île St-Quentin"
Inukjuak: "CO-OP Shop | Northern Shop | Tim Hortons | St Thomas Anglican | Nunavimmi Pigiursavik"
Chicoutimi: "Boulangerie Chicoutimi-Nord | Sorrento Pizzeria | La Pulperie de Chicoutimi | Petite Maison Blanche | La Voie Maltée"
Moncton: "Atlantic Superstore | Dollarama | Real Atlantic Superstore | Moncton Coliseum | Centennial Park"
Fredericton: "Regent Mall | Costco Pharmacy | Real Atlantic Superstore | Alcool NB Liquor | Picaroons Roundhouse"
Bathurst: "Chaleur Regional Hospital | Joey's Pub & Eatery | Mai's Restaurant | Atlantic Host | Dollarama"
Yarmouth: "Your Winners World | the Saint Ambrose Cathedral | Real Atlantic Superstore | Kia Motors | rent a center"
Gander: "Walmart Supercentre | Town Square | Arts And Culture Center | Dominion | Cobbs Pond Rotary Park"
Rigolet: "Nunatsiavut Government"
Port Burwell: "Port Rexton Brewing Co. | the Dildo Brewing Co & Museum | Au P'tit Mousse | Keith's Diner | La Terrasse à Steve"
Arecibo: "La Poza Del Obispo | Islote Beach Restaurants | the Arecibo Lighthouse & Historical Park Museum | Acuario (Arecibo Lighthouse & Historical Park) | Guarida De Piratas (Arecibo Lighthouse & Historical Park)"
Santa Cruz: "the Santa Cruz Beach Boardwalk | Santa Cruz Main Beach | Twin Lakes State Beach | Natural Bridges State Beach | Casino Arcade"
San Bernardino: "San Manuel Casino | Glen Helen Regional Park | Costco Food Court | Tutu’s Food Court | St. Bernardine Medical Center"
Bridgeport: "St. Vincent's Medical Center | Food Bazaar | Seaside Park | Macron Store | Duchess"
Rochester: "Erie Canal Trail | Highland Park | Strong National Museum of Play | Rochester Public Market | Ontario Beach Park"
International Falls: "The Jug Liquors | Border Bar Pizza | Backus Community Center | Ronning's Border Bargains | SuperOne"
St. Paul: "Xcel Energy Center | Hmong Village | Kowalski's Market | Cossetta's Italian Market & Pizzeria | Allianz Field"
Billings: "Rimrock Mall | MetraPark | Billings Studio Theatre Inc | Billings Clinic Hospital | Manny's"
Great Falls: "Holiday Village Mall | Cascade County Sheriff's office | Mighty Mo Beach Club | Halftime Sports Bar & Casino | Montana Club"
Missoula: "Fort Missoula Regional Park | Good Food Store | Yoke’s Fresh Market | Yoke's Fresh Market on Reserve | Goodwill Store"
Minot: "Schatz Crossroads | North Dakota State Fair Grounds | North Hill Market Place | Oak Park | Holiday Gas"
Fargo: "West Acres Mall | Sanford Medical Center | Essentia Health-Fargo | Food Court | The Shack"
Hilo: "KTA Superstores | Lili‘uokalani Park And Gardens | Rainbow Falls Park | Carlsmith Beach Park | Sack N Save"
Olympia: "Haggen Northwest Fresh | Capital Mall | Capital Medical Center | Washington State Capital Campus | Ralph's Thriftway"
Spokane: "River Park Square | Yoke's Fresh Market | Spokane Veterans Memorial Arena | Dwight Merkel Sports Complex | Riverfront Park"
Vancouver: "Tola Angkor Market | The Vancouver Clinic | Main Street Marijuana - East | Vancouver Farmers Market | Frontier Public House"
Flagstaff: "Flagstaff Mall | Bushmaster Park | Majestic Marketplace | Mother Road Brewing Company | North Pole Experience"
Tucson: "Gene C Reid Park | Spectrum Mall | Aqui Con El Nene | the Reid Park Zoo | Tumamoc Hill"
Santa Barbara: "Paseo Nuevo | Shoreline Park | Leadbetter Beach & Park | the Santa Barbara Zoo | Old Mission Santa Barbara"
Fresno: "River Park Shopping Center | Woodward Park | Kaiser Permanante | Villaggio Shopping Center | Dog House Grill"
Eureka: "Bayshore Mall | Harbor Lanes | Kaptain’s Quarters | Pierson's Building Center | Murphy's Market"
Colorado Springs: "Garden of the Gods | In-N-Out Burger | the Cheyenne Mountain Zoo | Garden of the Gods Trading Post | Bubba's 33"
Reno: "Idlewild Park | the Grand Sierra Grand Theatre | Shayden Summit | Hometown Cafe | Reno-Sparks Livestock Events Center"
Elko: "Union Pacific Railroad Terminal | Coffee Mug | Mattie's Sports Bar, Grill & Brewery | Elko City Park | Gun World and Archery"
Albuquerque: "Costco Food Court | North Domingo Baca Park | Tin Can Alley ABQ | Frontier | Taqueria El Paisa"
Salem: "The Yard Food Park | Keizer Station | CFC Futbol Club | Plaid Pantry | Salem Center"
Casper: "Blackmore Marketplace | Sagewood Elementary School | 307 Vision | Johnny J's Diner | Studio City Stadium 11"
Topeka: "Lake Shawnee | the Topeka & Shawnee County Public Library | the Combat Air Museum | banjo's cafe | The Wheel Barrel"
Kansas City: "Zona Rosa | Kauffman Stadium | City Market | GEHA Field at Arrowhead Stadium | the Kansas City Zoo & Aquarium"
Tulsa: "The Gathering Place | Golden Driller | BOK Center | Tandy Family YMCA | Utica Square Shopping Center"
Sioux Falls: "Western Mall | Shoppes at Dawley Farm | Falls Park | Denny Sanford PREMIER Center | Sanford USD Medical Center"
Shreveport: "Mall St. Vincent | Southern Classic Chicken | Johnny's Catfish & Seafood | Independence Stadium | Bergeron's Boudin & Cajun Meats"
Baton Rouge: "the Baton Rouge Zoo | Hi Nabor | Don Carter's All Star Lanes | Tony's Seafood | Mike Anderson's Seafood"
Ft. Worth: "Target | Dickies Arena | Montgomery Plaza | Alpine Shooting Range | Historic Stock Yards"
Corpus Christi: "La Palmera | Moore Plaza | Cole Park | Wings 'N More | Julio's Easy Stop"
Austin: "Zilker Park | Texas State Capitol | Barton Springs Pool | Auditorium Shores at Lady Bird Lake | Lady Bird Lake Trail (West)"
Amarillo: "Cinergy Amarillo Featuring EPIC | Westgate Mall | United Supermarkets | The Big Texan Steak Ranch | Spicy Mike's Bar-B-Q Haven"
El Paso: "Speaking Rock Casino And Entertainment | Union Draft House | Fort Bliss Main Exchange | Vista Central Market | Scenic Drive"
Laredo: "Independence Hills Regional Park | La Laguna | North Central Park | Sames Auto Arena | El Taco Tote"
Burlington: "University of Vermont Medical Center | Church Street Marketplace | City Market (Onion River Co-op) | Waterfront Park | Pearl Street Beverage"
Montgomery: "The Shoppes At Eastchase | Eastdale Mall | Wynton Blount Cultural Park | Brenda's Bar-B-Q Inc | Walk-On's Sports Bistreaux"
Tallahassee: "Costco Food Court | Cascades Park | Railroad Square Art Park | The Egg Cafe & Eatery | Palace Saloon"
Orlando: "ICON Park | Universal CityWalk | Universal's Islands of Adventure | Universal Studios Florida | The Wizarding World of Harry Potter - Hogsmeade"
Jacksonville: "Jacksonville Beach | NEX Navy Exchange | the Jacksonville Zoo | William F Sheffield Regional Park | VyStar Veterans Memorial Arena"
Savannah: "DEFY Extreme Air Sports | Candler Hospital | Daffin Park | Lake Mayer Park | Leopold's Ice Cream"
Columbia: "Shoppes at Woodhill | Publix Deli | the Riverbanks Zoo & Garden | Food Court | the Richland Library - Main Library"
Indianapolis: "Lucas Oil Stadium | the Indianapolis Zoo | White River State Park | The Children's Museum of Indianapolis | Long's Bakery"
Wilmington: "Cook Out | Winnie's Tavern | Halyburton Park | Cardinal Lanes Beach Bowl | Carolina Ale House"
Knoxville: "Kroger Marketplace Emory Rd | Sunspot | Thompson-Boling Arena | McKay Used Books, CDs, Movies & More | Lakeshore Park"
Richmond: "Willow Lawn | the Altria Theater | William Byrd Park | Cook-Out | Movieland At Boulevard Square"
Charleston: "Kanawha State Forest | China Buffet | Bridgeport Equipment & Tools | Booker T. Washington Memorial | Tudor's Biscuit World"
Baltimore: "Patterson Park | Mercy Medical Center | the National Aquarium | M&T Bank Stadium | Druid Hill Park"
Syracuse: "Destiny USA | Green Hills Farms | Central NY Regional Market | SUNY Upstate Medical University Hospital | Dunk & Bright"
Port-of-Spain: "International Waterfront Centre | The Savannah Strip | Long Circular Mall | Queen's Park Oval | Phase II Panyard"
Augusta: "Sparetime Recreation | MaineGeneral Alfond Center for Health | Marketplace at Augusta | The Red Barn | Damon's Beverage Mart"
Sault Ste. Marie: "Pino's | John Rhodes Community Centre | Ignition Eatery | Bellevue Park | Giovanni's"
Sitka: "Sea Mart Quality Foods | Japonski Island | Pizza Express | Alaska Raptor Center | Harry Race Pharmacy & Photo"
Mexicali: "Asadero Acatlan de Juarez | Plaza San Pedro | Plaza La Gran Via | China Town | Flautas "La Robledo""
La Paz: "Kiosko del Malecón | Mega Dulceria Sotres 1 | Bismark-cito | Malecón | Verde Mezcalina"
Torreon: "Pollo Feliz | GM Pizzas | Alsuper store | Hamburguesas Lucas | Línea Verde"
Culiacan: "Country Club | Forum Culiacán | Magara Real Food | Café Miró | Centro Histórico"
Nogales: "CAFFENIO Centro | Taqueria Lupita | Siete Mares | Fray Marcos Cocktail Lounge | Ley"
Hermosillo: "Plaza Dila | Galerías Mall | Los Lagos | FITMAX | Parque La Ruina"
Guaymas: "Unidad Deportiva Municipal Julio Alfonso Alfonso | Mariscos El Rey | Tacos el pipe | Miramar | El Mazateño"
San Luis Potosi: "Plaza Citadella | Plaza San Luis | Club de Golf La Loma | Parque Tangamanga | Palacio Municipal"
Matamoros: "Soriana canales | Restaurante García | Parque Periferico | Plaza Sendero | Soriana"
Nuevo Laredo: "Tacos "Tavita" | S-mart Suc. López de Lara | Paseo Reforma | Unidad Deportiva Benito Juárez | Plaza Miguel Hidalgo"
Colima: "Plaza San Fernando | Zentralia | Jardín de los Borrachos | Centro Histórico | Glorieta Rey Colimán"
Campeche: "Walmart Supercenter Electricistas | Malecón | Taquería "Norma Ruelas" | La Palapa del Tío Fito | La Verbena Sucursal Kala"
Oaxaca: "Templo de Santo Domingo de Guzmán | Catedral de Nuestra Señora de la Asunción | Mercado 20 de Noviembre | Zócalo | Paseo Juárez El Llano"
Leon: "Plaza Mayor | Centro Comercial Altacia | Hospital Aranda de la Parra | Quesadillas Y Gorditas | Parque Metropolitano"
Santiago de Cuba: "Castillo de San Pedro de la Roca | Plaza de Marte | Cementerio de Santa Ifigenia | El Palenquito | Plaza de la Revolución"
Santiago: "Parque Arauco | Sky Costanera | MUT Mercado Urbano Tobalaba | Cerro San Cristóbal | Parque Metropolitano de Santiago"
Thompson: "Riverview Express | I Scream Shack | Burntwood Regional Health Authority | Thompson General Hospital | Northern Inn & Steakhouse"
Brandon: "Shoppers Mall | Keystone Centre | Best West Pet Foods | Swiss Chalet | Mum's Family Restaurant"
Fort McMurray: "Joly's Your Independent Grocer | Bear & Buffalo | École Dickinsfield School | MacDonald Island Park | Timberlea Athletic Park"
Peace River: "Baytex Energy Centre | Peace River CoOp | Co-op Gas Bar | Reddi Mart | Riverfront park"
Fort St. John: "Casey's Pub | Canadian Tire | Church Of The Resurrection | Best Western Coachman Inn Fort Saint John | Peace River Building Products Ltd"
Iqaluit: "Apex Road QuickStop | Aqsarniit Middle School | North Mart | Artic Ventures - Bell Authorized Dealer | Storehouse Bar & Grill"
Cambridge Bay: "Ikaluktutiak Co-Op <KUAP> | Kiilinik High School | Kuugaq Cafe | Municipality of Cambridge Bay | Woodtown, Nu"
Kugluktuk: "🇨🇦 Kugluktuk"
Chesterfield Inlet: "Pitsiulak Co-op | Ice Pan On the Hudson Bay | Canteen @ Yuan Ching Secondary School | Victor Sammurtok School"
Arviat: "E.P.L.S. Home | Tim Hortons"
Taloyoak: "Hamlet Office Of Taloyoak | Taloyoak"
Igloolik: "Northern Grocery"
Dawson City: "Bonanza Gold Campground | Bonanza Cafe | Jack London Cabin & Interpretive Centre | Midnight Dome | Dawson City General Store"
Timmins: "McIntyre Arena | the St Anthonys Church | Chez Nous Store / Poutine | Caseys | Timmins Square"
North Bay: "Parker's Your Independent Grocer | Average Joe's | Memorial Gardens | Northgate Shopping Centre | Hoagie's Diner"
Kuujjuarapik: "Tim Hortons | Kuujjuarapik Youth Center"
Kuujjuaq: "Northern | Kativik Regional Government Building | UTHC | HFT Association | Jaanimmarik School"
Sydney: "Membertou Heritage Park | TRA Cash & Carry | The Joan Hariss Cruise Pavillion | The Big Fiddle | Open Hearth Park"
Labrador City: "Menihek High School | Mavericks | Lakeside Convenience | Baba Q’s | Labrador Mall"
Helena: "Lewis And Clark County Fairgrounds | Swimming Pool And Hot Tub | Blackfoot River Brewing Company | Van's Thriftway | St. Peter's Medical Group North Montana"
Bismarck: "Holiday Station Store | Cottonwood Soccer Complex | Grand Theatres | Williquors | Jack's Steakhouse"
Boise: "St. Luke's Boise Medical Center | Ann Morrison Park | Julia Davis Park | Los Betos | Dutch Bros Coffee"
San Jose: "Santana Row | SAP Center at San Jose | Mitsuwa Marketplace | Sharks Ice at San Jose | Bazille"
Sacramento: "Delta Shores Shopping Center | Town & Country Village | Golden 1 Center | Loehmann's Plaza | William Land Park"
Las Vegas: "Fremont Street Experience | The LINQ Promenade | Miracle Mile Shops | Town Square | Fountains of Bellagio"
Santa Fe: "the Southside Library | Ragle Park | Santa Fe Brewing Company | El Parasol | Meow Wolf"
Portland: "Washington Park | Mt. Tabor Park | the Oregon Zoo | Gov. Tom McCall Waterfront Park | Oregon Museum of Science & Industry"
Salt Lake City: "Delta Sky Club Bar | Delta Center | Liberty Park | Harmons Grocery | City Creek Center Food Court"
Cheyenne: "Outlaw Saloon | Town & Country Liquors | Tortilla Factory | Holliday park | Lions Park"
Des Moines: "Wells Fargo Arena | the Blank Park Zoo | Fareway | Flix Brewhouse | Smokey Row Coffee"
Omaha: "Old Market | Sorensen Park Plaza | the Henry Doorly Zoo and Aquarium | Aksarben Village | Costco Bakery"
Oklahoma City: "Paycom Center | Myriad Botanical Gardens | Scissortail Park | The Oklahoma City Zoo | Science Museum Oklahoma"
Pierre: "Lynn's Dakotamart | Runnings | Jake's Good Times Place | Avera Medical Associates Clinic | Lariat Lanes"
San Antonio: "H-E-B | Frost Bank Center | Alamo Quarry Market | The Alamo | Costco Food Court"
Jackson: "Highland Village | Cups @ UMMC | Medgar Evers' Home | Bully's Great Soul Food | The Pig & Pint"
Raleigh: "Crabtree Valley Mall | North Hills Shopping Center | Village District | Belk Men's Store | State Farmers Market"
Cleveland: "Cleveland Clinic - Main Campus | Rocket Arena | Progressive Field | Edgewater Park | Louis Stokes Cleveland VA Medical Center"
Cincinnati: "the Cincinnati Zoo & Botanical Garden | John G & Phyllis W Smale Riverfront Park | Riverbend Music Center | PNC Pavilion | Fountain Square"
Nashville: "Radnor Lake State Park | Percy Warner Park | Bridgestone Arena | Centennial Park | Nissan Stadium"
Memphis: "Shelby Farms Park | FedExForum | Crosstown Concourse | the Memphis Zoo | Overton Park"
Norfolk: "Costco Snack Bar | NEX Naval Station Norfolk | MacArthur Center | Norfolk Scope Arena | Waterside District"
Milwaukee: "Fiserv Forum | Milwaukee Public Market | the Milwaukee County Zoo | BMO Club | Cathedral Square Park"
Buffalo: "KeyBank Center | Wegmans Market Cafe | Delaware Park | Martin Luther King Park | Buffalo RiverWorks"
Pittsburgh: "Dancing Gnome | PPG Paints Arena | Market Square | Carnegie Science Center | The Warren Bar & Burrow"
Kodiak: "Island Espresso | Kodiak Bible Chapel | Kodiak Hana | Ardinger's Fine Furnishings | Henry's Great Alaskan Restaurant"
Cold Bay: "the Cold Bay Library | Izembek National Wildlife Refuge | Barefoot Inn"
Bethel: "Alba's Coffee Shop | Red Basket Restaurant | Cultural Center | Zen | Uncommon Pizza"
Point Hope: "Point Hope, Alaska | Point Hope Native Store | Pt. Hope | Point Hope | Challenge Life"
Barrow: "Sam & Lees Restaurant | the Tuzzy Consortium Library | Samual Simmonds Memorial Hospital | Arctic Ocean | ALASKA | Polar Bear Club"
Nome: "FAA HOUSING | Landons | NSEDC | Eskimo Walrus Commission | Nome Flight Servuce Station (FAA)"
Valdez: "the Valdez Museum | The Fat Mermaid | Dock Point | the Maxine and Jesse Whitney's Museum | Solomon Gultch Hatchery"
Juneau: "Breeze In | Mendenhall Glacier | Glacier Cinemas | Red Dog Saloon | Breeze-In Grocery"
Fairbanks: "AAFES PX/Commissary | Ft. Wainwright Shoppette | Aurora Crepes And Peking Duck | Pioneer Park | Value Village"
Prudhoe Bay: "Prudhoe Bay General Store | ConocoPhillips Well Pad 2E | Nordic 2 Rig | W Pad | CPF3"
Port-au-Prince: "Palais Municipal de Delmas | Librairie La Pleiade | Epi d'Or | Delimart @ Delmas | Natcom"
Paramaribo: "Tulip (Unbeatable Shopping Pleasure) | Kaki | Choi | Mirage Casino | Fort Zeelandia"
Tijuana: "Parque de la Amistad | Tacos El Dorado | Mercado Hidalgo | Plaza Galerías Hipódromo | Tacos El Franc"
Chihuahua: "Distrito 1 | Grutas Nombre de Dios | Star Médica Chihuahua | Alsuper Tres Vías | AlSuper Santa Fe"
Mazatlan: "Malecón | Playa Brujas | Kelly's Bar | Stone Island (Isla de la Piedra) | Clavadistas"
Tampico: "Altama City Center | Degas Café | Parque El Charro | Laguna del Carpintero | Parque Metropolitano"
Acapulco: "Chedraui Selecto | Malecón | Prichos | La Ribaicita | Bahía de Acapulco"
Veracruz: "Gran Café de la Parroquia | Acuario de Veracruz | Macroplaza del Malecón | Los Farolitos | Café El Alba"
Tuxtla Gutierrez: "Ámbar Fashion Mall | Liverpool Oriente | Paralelo Café | Caña Hueca | Tacos Casa Blanca"
Cancun: "La Isla Shopping Village | Marina Puerto Cancún | Coco Bongo | Plaza Las Américas | Playa Delfines (El Mirador)"
Merida: "Plaza Altabrisa | Galerías Mérida | City Center | Uptown Mérida (Plaza UpTown) | Paseo 60"
Kingston: "Tastee | 24 Seven Cafe | Emancipation Park | Hi Lo Supermarket | Jamaica Defence Force"
Winnipeg: "Polo Park Shopping Centre | Outlet Collection Winnipeg | St. Vital Shopping Centre | The Forks Historic Site | Sobeys Extra"
Churchill: "Hudson Bay Beach | Ptarmigan | Liquor Mart | the Itsanitaq Museum | the Eskimo Museum"
Regina: "Wascana Park | Wholesale Club | Co-op | Nicky's Cafe & Bake Shop | Golden Mile Shopping Centre"
Saskatoon: "Co-op | Wilson's Greenhouse | Co-op Marketplace | Midtown Plaza | Lawson Heights Mall"
Calgary: "Chinook Centre | Spruce Meadows | Southcentre Mall | CF Market Mall | St. Patrick's Island"
Prince Rupert: "Rotary Waterfront Park | City Hall | Rupert Square | Museum of Northern BC | Liquor Warehouse"
Victoria: "Beacon Hill Park | Ogden Point Breakwater | Clover Point | the Royal British Columbia Museum | Bolen Books"
Arctic Bay: "D'Persada YAB | Canadian Post"
Resolute: "Polar Shelf Continental Program"
Yellowknife: "Co-op | Glen's Your Independent Grocer | Trevor's Your Independent Grocer | Stanton Territorial Hospital | NJ Macpherson School"
Fort Good Hope: "Duman Senden Daha Guzell"
Whitehorse: "Yukon Brewing | Whitehorse Fish Rapids | Yukon Beringia Interpretive Centre | Shipyard's Park | S.S. Klondike National Historic Site"
Ottawa: "Commissioners Park | the Canada Science and Technology Museum | CF Rideau Centre | Scotiabank Theatre Ottawa | Mid East Food Centre"
Thunder Bay: "Intercity Shopping Centre | Whitewater Golf Club | Port Arthur Arena | Maltese Grocery | Value Village"
Québec: "Laurier Quebec | Les Galeries de la Capitale | Parc linéaire des rivières Saint-Charles et du Berger | Centre Vidéotron | Fruiterie 440"
Halifax: "Halifax Shopping Centre | Parkside Pub & Grill | Real Atlantic Superstore | Point Pleasant Park | Dave's Fruit and Vegetables"
St. Johns: "Port Rexton Brewing Co. | the Dildo Brewing Co & Museum | Au P'tit Mousse | Keith's Diner | La Terrasse à Steve"
Nain: "Canadian Post"
Charlottetown: "Real Atlantic Superstore | Queen Elizabeth Hospital | Liquor Store | Red Shores Racetrack & Casino | Maid Marian's Diner"
San Juan: "Puerto Rico Port Old San Juan | Distrito T-Mobile | Plaza del Mercado de Santurce | Plaza Colón | Escambron Beach"
Minneapolis: "Target Field | U.S. Bank Stadium | Minnehaha Park | Lake Of The Isles | Minnehaha Falls"
Honolulu: "Royal Hawaiian Center | Waikīkī Beach | Navy Exchange | Ala Moana Beach Park | Mitsuwa Marketplace"
Seattle: "University Village | Pike Place Market | Seattle Center | Lumen Field | Space Needle"
Phoenix: "Desert Ridge Marketplace | Phoenix Children's Hospital | the Phoenix Zoo | Encanto Park | the Desert Botanical Garden"
San Diego: "Balboa Park | Mission Beach | Mission Bay Park | Seaport Village | La Jolla Cove"
St. Louis: "the Saint Louis Zoo | Enterprise Center | Ballpark Village St. Louis | Forest Park | Tower Grove Park"
New Orleans: "New Orleans City Park | Café du Monde | French Market | Jackson Square | Fair Grounds Race Course & Slots"
Dallas: "NorthPark Center | Galleria Dallas | American Airlines Center | Fair Park | Toyota Music Factory"
Boston: "the TD Garden | Boston Common | Faneuil Hall Marketplace | the Boston Public Garden | Quincy Market"
Tampa: "Amalie Arena | George M Steinbrenner Field | Cheetah Hunt | Raymond James Stadium Luxury Suite | the Tampa's Lowry Park Zoo"
Philadelphia: "Philadelphia Sports Complex | Reading Terminal Market | Dilworth Park | Lincoln Financial Field | Fairmount Park"
Detroit: "Little Caesars Arena | Comerica Park | Ford Field | Belle Isle Park | Eastern Market"
Anchorage: "Dimond Center Mall | Tikahtnu Commons | Costco Food Court | Providence Alaska Medical Center | 49th State Brewing"
Guadalajara: "Midtown Jalisco | Zoológico Guadalajara | Catedral Basílica de la Asunción de María Santísima | Barranca de Huentitán | Plaza de La Liberación"
Puebla: "Angelópolis Lifestyle Center | Solesta | Fuente de Sodas | Experiencia Gourmet | Parque Puebla"
Havana: "Plaza de la Revolución | Plaza de Armas | Plaza de San Francisco | Plaza de la Catedral | Parque Lennon"
Santo Domingo: "Ágora Mall | Galería 360 | Blue Mall Shopping Center | Parque Mirador Sur | Supermercado Bravo"
Edmonton: "West Edmonton Mall | Southgate Centre | The Meadows Community Recreation Center | Rogers Place | Scotiabank Theatres"
Montréal: "Parc Jean-Drapeau | Mount Royal Park (Parc du Mont-Royal) | Bell Centre (Centre Bell) | Parc de la Promenade-Bellerive | Parc La Fontaine"
San Francisco: "Golden Gate Park | Ferry Building Marketplace | Oracle Park | Mission Dolores Park | Chase Center"
Denver: "Ball Arena | Empower Field at Mile High | Washington Park | City Park | the Denver Zoo"
Houston: "NRG Stadium | Toyota Center | the Houston Zoo | Hermann Park | Memorial Park"
Miami: "Kaseya Center | Bayfront Park | Versailles | The Shops At Midtown Miami | Adrienne Arsht Center for the Performing Arts"
Atlanta: "Atlantic Station | Ponce City Market | Mercedes-Benz Stadium | the Georgia Aquarium | Piedmont Park"
Chicago: "Millennium Park | United Center | Cloud Gate | Museum Campus | Chicago Riverwalk"
Monterrey: "Galerías Monterrey | Plaza VIA02 | Fundidora Park (Parque Fundidora) | Galerías Valle Oriente | Pueblo Serena"
Vancouver: "Kitsilano Beach | Pacific Spirit Regional Park | Stanley Park | Queen Elizabeth Park | Stanley Park English Bay Seawall"
Toronto: "Yorkdale Shopping Centre | Rogers Centre | Scotiabank Arena | High Park | CN Tower"
Los Angeles: "The Grove | Griffith Park | Universal Studios Hollywood Globe and Fountain | Crypto.com Arena | Venice Beach"
Washington: "West Potomac Park | The Wharf DC | CityCenterDC | National Museum of American History | National Museum of African American History and Culture"
New York: "Central Park | Bryant Park | National September 11 Memorial | 9/11 Memorial North Pool | Metropolitan Museum of Art"
Mexico City: "Bosque de Chapultepec | National Auditorium (Auditorio Nacional) | Parque México | Palacio de Bellas Artes | Monumento a la Independencia"