Hardin: "Big Horn County Museum | the Little Bighorn College | the jail | the old courthouse | County courthouse"
Glendive: "Frontier Gateway Museum | Makoshika State Park | Dawson County Courthouse | the old courthouse | the jail"
Dillon: "the University of Montana Western | Beaverhead County Museum | the old courthouse | the jail | County courthouse"
Polson: "Miracle of America Museum | Mission Mountain Winery | the old courthouse | Flathead Lake State Park | the central business district"
Devils Lake: "Fort Totten State Historic Site | the Lake Region Heritage Center | Ramsey County Courthouse | the old courthouse | the jail"
Burley: "Cassia County Museum | the old courthouse | the jail | County courthouse | Snake River Heritage Center"
Wallace: "the Wallace District Mining Museum | Sierra Silver Mine Tour | the old courthouse | the Oasis Bordello Museum | the central business district"
Kennewick: "Columbia Park | the East Benton County Historical Museum | the old courthouse | Three Rivers Children's Festival grounds | the central business district"
Centralia: "the Centralia Antique Mall | Fort Borst Park | the old courthouse | the jail | the George Washington Park"
Glendale: "Arrowhead Ranch | the Thunderbird Conservation Park | the old courthouse | Foothills Recreation Center | the central business district"
Safford: "Eastern Arizona College | Mount Graham | the old courthouse | the jail | Graham County Courthouse"
Casa Grande: "Casa Grande Ruins National Monument | the Francisco Grande Hotel & Golf Resort | the old courthouse | the jail | the central business district"
Mesa: "Mesa Arts Center | the Arizona Museum of Natural History | Hohokam Stadium | the old courthouse | the jail"
Lake Havasu City: "the London Bridge | Lake Havasu State Park | the old courthouse | Rotary Community Park | the central business district"
Berkeley: "the University of California Berkeley | Telegraph Avenue | the Berkeley Rose Garden | the old courthouse | the Lawrence Berkeley National Laboratory"
National City: "the Mile of Cars | Pepper Park | the old courthouse | the jail | the Kimball House"
Mendocino: "Mendocino Headlands State Park | the Mendocino Art Center | the old courthouse | the Kelley House Museum | the central business district"
Paso Robles: "Paso Robles Wine Country | the Paso Robles Event Center | the old courthouse | the jail | the Carnegie Historical Library"
Riverside: "the Mission Inn Hotel & Spa | the University of California Riverside | Mount Rubidoux | the old courthouse | the jail"
Delano: "the Delano Historical Society Museum | the jail | the old courthouse | the Filipino Community Center | the central business district"
San Mateo: "the jail | the San Mateo County History Museum | the old courthouse | Hillsdale Mall | the Japanese Tea Garden"
Vallejo: "Mare Island Historic Park | the Vallejo Naval and Historical Museum | the old courthouse | the jail | Six Flags Discovery Kingdom"
Glenwood Springs: "the Glenwood Hot Springs Pool | the Hotel Colorado | the old courthouse | the Frontier Historical Museum | the central business district"
Aurora: "the Aurora History Museum | the jail | the old courthouse | the Plains Conservation Center | the central business district"
Greeley: "the University of Northern Colorado | the jail | the old courthouse | the Greeley History Museum | the central business district"
Tonopah: "the Central Nevada Museum | the old courthouse | the Mizpah Hotel | the jail | the Tonopah Historic Mining Park"
Deming: "the Deming Luna Mimbres Museum | the old courthouse | the jail | the New Mexico National Guard Armory | the central business district"
Truth or Consequences: "the Geronimo Springs Museum | the old courthouse | the jail | Elephant Butte Lake State Park | the central business district"
Las Vegas: "the City of Las Vegas Museum | the old courthouse | the jail | the Carnegie Library | the central business district"
Farmington: "the Farmington Museum | San Juan College | the old courthouse | the jail | the E3 Children's Museum & Science Center"
Springfield: "the Springfield Museum | the old courthouse | the jail | Willamette University | the central business district"
Tillamook: "the Tillamook Cheese Factory | the Tillamook Air Museum | the old courthouse | the jail | the central business district"
Ontario: "the Four Rivers Cultural Center | the old courthouse | the jail | the Treasure Valley Community College | the central business district"
La Grande: "Eastern Oregon University | the old courthouse | the jail | the Union County Museum | the central business district"
Richfield: "the old courthouse | the jail | the Sevier County Courthouse | the Fremont Indian State Park | the central business district"
Nephi: "the old courthouse | the jail | the Juab County Courthouse | the Nephi City Cemetery | the central business district"
Lander: "the Museum of the American West | the old courthouse | the jail | the Fremont County Courthouse | the central business district"
Powell: "the Heart Mountain Interpretive Center | the old courthouse | the jail | Northwest College | the central business district"
Paragould: "Crowley's Ridge State Park | the old courthouse | the jail | the Arkansas State University campus | the Greene County Courthouse"
Iowa City: "the University of Iowa | the Old Capitol Building | the old courthouse | the jail | the Iowa Writers' Workshop"
Ottumwa: "the Wapello County Museum | the old courthouse | the jail | the Bridge View Center | the American Gothic House"
Spencer: "the Clay County Fair | the old courthouse | the jail | the Spencer Municipal Airport | the central business district"
Ft. Dodge: "Historic Fort Dodge | the Blanden Memorial Art Museum | the old courthouse | the jail | the Webster County Courthouse"
Hutchinson: "the Kansas Cosmosphere and Space Center | the old courthouse | the jail | the Reno County Courthouse | the Kansas State Fairgrounds"
Kansas City: "the Argentine District | the old courthouse | the jail | the University of Kansas Medical Center | the Wyandotte County Courthouse"
Lawrence: "the University of Kansas | Massachusetts Street | the old courthouse | the Spencer Museum of Art | South Park"
Garden City: "the Lee Richardson Zoo | the old courthouse | the jail | the Finney County Courthouse | the Buffalo Dunes Golf Course"
Manhattan: "Kansas State University | Aggieville | the old courthouse | the jail | the Riley County Courthouse"
Hays: "Fort Hays State University | the old courthouse | the jail | the Ellis County Courthouse | the Sternberg Museum of Natural History"
Goodland: "the High Plains Museum | the old courthouse | the jail | the Sherman County Courthouse | the Giant Van Gogh Painting"
Independence: "the Harry S. Truman Presidential Library | the old courthouse | the jail | the Jackson County Courthouse | the National Frontier Trails Museum"
Kirksville: "Truman State University | the old courthouse | the jail | the Adair County Courthouse | the Thousand Hills State Park"
Kearney: "the Great Platte River Road Archway | the old courthouse | the jail | the University of Nebraska at Kearney | the Buffalo County Courthouse"
Grand Island: "Stuhr Museum of the Prairie Pioneer | the old courthouse | the jail | the Hall County Courthouse | the Nebraska State Fair Park"
Alliance: "the Knight Museum | the old courthouse | the jail | the Box Butte County Courthouse | Carhenge"
Bartlesville: "the Price Tower | the Woolaroc Museum | the old courthouse | the jail | the Washington County Courthouse"
Enid: "the Cherokee Strip Regional Heritage Center | the old courthouse | the jail | the Garfield County Courthouse | Northwestern Oklahoma State University"
Ardmore: "the Eliza Cruce Hall Doll Museum | the old courthouse | the jail | the Carter County Courthouse | the Greater Southwest Historical Museum"
McAlester: "the Oklahoma Prison Historical Museum | the old courthouse | the jail | the Pittsburg County Courthouse | the McAlester Scottish Rite Temple"
Stillwater: "Oklahoma State University | the old courthouse | the jail | the Payne County Courthouse | the National Wrestling Hall of Fame"
Lead: "the Homestake Opera House | the old courthouse | the jail | the Black Hills Mining Museum | the Sanford Underground Research Facility"
Slidell: "the Slidell Museum | the old courthouse | the jail | the Slidell Cultural Center | Fontainebleau State Park"
Lake Charles: "the Imperial Calcasieu Museum | the old courthouse | the jail | the Calcasieu Parish Courthouse | the Lake Charles Civic Center"
Metairie: "Lakeside Shopping Center | the Metairie Cemetery | the jail | the Jefferson Parish Courthouse | the Treasure Chest Casino"
New Iberia: "the Shadows-on-the-Teche | the old courthouse | the jail | the Iberia Parish Courthouse | the Conrad Rice Mill"
Bryan: "the George H.W. Bush Presidential Library | the old courthouse | the jail | Texas A&M University | the Brazos County Courthouse"
San Marcos: "Texas State University | the Wonder World Cave | the old courthouse | the jail | the San Marcos Premium Outlets"
Longview: "the Gregg County Historical Museum | the old courthouse | the jail | the Gregg County Courthouse | LeTourneau University"
McAllen: "the International Museum of Art & Science | the old courthouse | the jail | the Hidalgo County Courthouse | Quinta Mazatlan"
Harlingen: "the Iwo Jima Memorial | the old courthouse | the jail | the Cameron County Courthouse | the Rio Grande Valley Museum"
Alice: "the South Texas Museum | the old courthouse | the jail | the Jim Wells County Courthouse | the Alice Echo News Journal building"
New Braunfels: "Schlitterbahn Waterpark | the old courthouse | the jail | the Comal County Courthouse | Gruene Historic District"
Cleburne: "the Layland Museum | the old courthouse | the jail | the Johnson County Courthouse | Cleburne State Park"
Brownwood: "the Martin Walker House Museum | the old courthouse | the jail | the Brown County Courthouse | Howard Payne University"
Alpine: "Sul Ross State University | the old courthouse | the jail | the Brewster County Courthouse | the Museum of the Big Bend"
Van Horn: "the Culberson County Courthouse | the old courthouse | the jail | the Van Horn Visitor Center | Red Rock Ranch"
Big Spring: "the Heritage Museum | the old courthouse | the jail | the Howard County Courthouse | Big Spring State Park"
Vernon: "the Red River Valley Museum | the old courthouse | the jail | the Wilbarger County Courthouse | Vernon College"
Childress: "the Childress County Heritage Museum | the old courthouse | the jail | the Childress County Courthouse | the City Park"
Hereford: "the National Cowgirl Museum | the old courthouse | the jail | the Deaf Smith County Courthouse | the Hereford Brand building"
Dalhart: "the XIT Museum | the old courthouse | the jail | the Hartley County Courthouse | the Dallam County Courthouse"
Texas City: "the Texas City Museum | the old courthouse | the jail | the Galveston County Courthouse Annex | the Texas City Dike"
Pasadena: "the Pasadena Historical Museum | the old courthouse | the jail | the Harris County Courthouse Annex | San Jacinto College"
Baytown: "the Baytown Historical Museum | the old courthouse | the jail | the Harris County Courthouse Annex | Lee College"
Arlington: "the Arlington Museum of Art | the old courthouse | the jail | the Tarrant County Courthouse Annex | the University of Texas at Arlington"
New London: "the Lyman Allyn Art Museum | the old courthouse | the jail | Connecticut College | the Custom House Maritime Museum"
Stamford: "the Stamford Museum & Nature Center | the old courthouse | the jail | the University of Connecticut Stamford | the Palace Theatre"
Waterbury: "the Mattatuck Museum | the old courthouse | the jail | the Post University | the Palace Theater"
New Bedford: "the New Bedford Whaling Museum | the old courthouse | the jail | the University of Massachusetts Dartmouth | the Zeiterion Performing Arts Center"
Springfield: "the Springfield Museums | the old courthouse | the jail | Western New England University | the MassMutual Center"
Salem: "the Peabody Essex Museum | the old courthouse | the jail | Salem State University | the House of the Seven Gables"
Pittsfield: "the Berkshire Museum | the old courthouse | the jail | Berkshire Community College | the Colonial Theatre"
Montpelier: "the Vermont History Museum | the old courthouse | the jail | Vermont College of Fine Arts | the Lost Nation Theater"
Auburn: "Auburn University | the old courthouse | the jail | the Lee County Courthouse | Chewacla State Park"
Florence: "the University of North Alabama | the old courthouse | the jail | the Lauderdale County Courthouse | Wilson Park"
Winter Haven: "Legoland Florida | the old courthouse | the jail | the Polk County Courthouse | the Chain of Lakes Park"
Melbourne: "the Florida Institute of Technology | the old courthouse | the jail | the Brevard County Courthouse | the Foosaner Art Museum"
Homestead: "the Coral Castle | the old courthouse | the jail | the Miami-Dade County Courthouse South | Homestead-Miami Speedway"
Sanford: "the old courthouse | the jail | Seminole State College | the Seminole County Courthouse | the Central Florida Zoo"
Miami Beach: "South Beach | the Art Deco Historic District | Lincoln Road | the Bass Museum | Ocean Drive"
Coral Springs: "the Coral Springs Museum of Art | the old courthouse | the jail | the Broward County Courthouse North | the Coral Springs Covered Bridge"
Port Charlotte: "Fishermen's Village | the old courthouse | the jail | the Charlotte County Courthouse | Peace Park"
Spring Hill: "Weeki Wachee Springs State Park | the old courthouse | the jail | the Hernando County Courthouse | the SunCoast Theatre"
Palm Coast: "Washington Oaks Gardens State Park | the old courthouse | the jail | the Flagler County Courthouse | the European Village"
Palatka: "the Bronson-Mulholland House | the old courthouse | the jail | the Putnam County Courthouse | Ravine Gardens State Park"
Leesburg: "the Leesburg Heritage Museum | the old courthouse | the jail | the Lake County Courthouse | Venetian Gardens"
Lake City: "the Columbia County Historical Museum | the old courthouse | the jail | the Columbia County Courthouse | Florida Gateway College"
Crestview: "the Blackwater Heritage State Trail | the old courthouse | the jail | the Okaloosa County Courthouse Annex | the Hub City Railroad Museum"
Panama City: "the Panama City Marina | the old courthouse | the jail | the Bay County Courthouse | Gulf World Marine Park"
Dalton: "the Creative Arts Guild | the old courthouse | the jail | the Whitfield County Courthouse | Dalton State College"
Marietta: "the Marietta Museum of History | the old courthouse | the jail | the Cobb County Courthouse | Kennesaw Mountain National Battlefield Park"
Waycross: "the Okefenokee Heritage Center | the old courthouse | the jail | the Ware County Courthouse | Laura S. Walker State Park"
La Grange: "the LaGrange Art Museum | the old courthouse | the jail | the Troup County Courthouse | LaGrange College"
Southaven: "the Southaven Towne Center | the old courthouse | the jail | the DeSoto County Courthouse | Snowden Grove Park"
Meridian: "the Meridian Museum of Art | the old courthouse | the jail | the Lauderdale County Courthouse | Meridian Community College"
Laurel: "the Lauren Rogers Museum of Art | the old courthouse | the jail | the Jones County Courthouse | Mason's Park"
Spartanburg: "the Hub City Railroad Museum | the old courthouse | the jail | the Spartanburg County Courthouse | Wofford College"
Orangeburg: "the Orangeburg County Fine Arts Center | the old courthouse | the jail | the Orangeburg County Courthouse | South Carolina State University"
Galesburg: "Knox College | the old courthouse | the jail | the Knox County Courthouse | the Galesburg Railroad Museum"
Joliet: "the Joliet Area Historical Museum | the old courthouse | the jail | the Will County Courthouse | the University of St. Francis"
Cape Girardeau: "Southeast Missouri State University | the old courthouse | the jail | the Cape Girardeau County Courthouse | the Red House Interpretive Center"
Rockford: "the Burpee Museum of Natural History | the old courthouse | the jail | the Winnebago County Courthouse | Anderson Japanese Gardens"
Evanston: "Northwestern University | the old courthouse | the jail | the Cook County Courthouse Skokie | the Block Museum of Art"
Rock Island: "the Quad City Botanical Center | the old courthouse | the jail | the Rock Island County Courthouse | Augustana College"
Elgin: "the Elgin History Museum | the old courthouse | the jail | the Kane County Courthouse | Elgin Community College"
Richmond: "the Wayne County Historical Museum | the old courthouse | the jail | the Wayne County Courthouse | Earlham College"
Terre Haute: "Indiana State University | the old courthouse | the jail | the Vigo County Courthouse | the Candles Holocaust Museum"
Lafayette: "Purdue University | the old courthouse | the jail | the Tippecanoe County Courthouse | the Tippecanoe Battlefield Museum"
Marion: "the Marion Palace Theatre | the old courthouse | the jail | the Grant County Courthouse | Indiana Wesleyan University"
South Bend: "the University of Notre Dame | the old courthouse | the jail | the St. Joseph County Courthouse | the Studebaker National Museum"
New Albany: "the Floyd County Museum | the old courthouse | the jail | the Floyd County Courthouse | Indiana University Southeast"
Elkhart: "the Midwest Museum of American Art | the old courthouse | the jail | the Elkhart County Courthouse | Goshen College"
Hopkinsville: "the Pennyroyal Area Museum | the old courthouse | the jail | the Christian County Courthouse | Hopkinsville Community College"
London: "the Laurel County Courthouse | the old courthouse | the jail | the World Chicken Festival grounds | Levi Jackson Wilderness Road State Park"
Madisonville: "the Madisonville City Park | the old courthouse | the jail | the Hopkins County Courthouse | Madisonville Community College"
Rocky Mount: "the Rocky Mount Arts Center | the old courthouse | the jail | the Nash County Courthouse | the Imperial Centre for the Arts"
Salisbury: "the Salisbury Historic District | the old courthouse | the jail | the Rowan County Courthouse | Catawba College"
Durham: "Duke University | the old courthouse | the jail | the Durham County Courthouse | the North Carolina Museum of Life and Science"
Lumberton: "the Robeson County Museum | the old courthouse | the jail | the Robeson County Courthouse | the University of North Carolina at Pembroke"
Zanesville: "the Zanesville Museum of Art | the old courthouse | the jail | the Muskingum County Courthouse | Muskingum University"
Mansfield: "the Mansfield Art Center | the old courthouse | the jail | the Richland County Courthouse | the Ohio State Reformatory"
Bowling Green: "Bowling Green State University | the old courthouse | the jail | the Wood County Courthouse | the National Tractor Pulling Championships"
Springfield: "the Springfield Museum of Art | the old courthouse | the jail | the Clark County Courthouse | Wittenberg University"
Lancaster: "the Fairfield Heritage Association Museum | the old courthouse | the jail | the Fairfield County Courthouse | Ohio University Lancaster"
Johnson City: "East Tennessee State University | the old courthouse | the jail | the Washington County Courthouse | the Hands On! Discovery Center"
Kingsport: "the Kingsport Aquatic Center | the old courthouse | the jail | the Sullivan County Courthouse | the Exchange Place"
Columbia: "the Maury County Museum | the old courthouse | the jail | the Maury County Courthouse | Columbia State Community College"
Barlett: "the Bartlett Museum | the old courthouse | the jail | the Shelby County Courthouse East | Bartlett Woods"
Blacksburg: "Virginia Tech | the old courthouse | the jail | the Montgomery County Courthouse | the Virginia Tech Corporate Research Center"
Harrisonburg: "James Madison University | the old courthouse | the jail | the Rockingham County Courthouse | the Edith J. Carrier Arboretum"
Petersburg: "the Petersburg National Battlefield | the old courthouse | the jail | the Petersburg Circuit Court | Virginia State University"
Hampton: "the Hampton History Museum | the old courthouse | the jail | the Hampton Circuit Court | Hampton University"
Sheboygan: "the John Michael Kohler Arts Center | the old courthouse | the jail | the Sheboygan County Courthouse | the Above & Beyond Children's Museum"
Waukesha: "the Waukesha County Museum | the old courthouse | the jail | the Waukesha County Courthouse | Carroll University"
La Crosse: "the University of Wisconsin-La Crosse | the old courthouse | the jail | the La Crosse County Courthouse | Grandad Bluff"
Eau Claire: "the University of Wisconsin-Eau Claire | the old courthouse | the jail | the Eau Claire County Courthouse | the Pablo Center at the Confluence"
Tomah: "the Tomah Area Historical Society Museum | the old courthouse | the jail | the Monroe County Courthouse | the Cranberry Discovery Center"
Janesville: "the Rock County Historical Society | the old courthouse | the jail | the Rock County Courthouse | the Janesville Performing Arts Center"
Appleton: "Lawrence University | the old courthouse | the jail | the Outagamie County Courthouse | the Building for Kids"
Parkersburg: "the Blennerhassett Museum | the old courthouse | the jail | the Wood County Courthouse | the Oil & Gas Museum"
White Sulphur Springs: "the Greenbrier Resort | the old courthouse | the jail | the Greenbrier County Courthouse | the President's Cottage Museum"
Clarksburg: "the Waldomore Museum | the old courthouse | the jail | the Harrison County Courthouse | Salem University"
Dover: "the Delaware State Museum | the old courthouse | the jail | the Kent County Courthouse | Delaware State University"
St. Charles: "the St. Charles County Historical Society Museum | the old courthouse | the jail | the St. Charles County Courthouse | Lindenwood University"
Annapolis: "the U.S. Naval Academy | the old courthouse | the jail | the Anne Arundel County Courthouse | the Maryland State House"
Hagerstown: "the Washington County Museum of Fine Arts | the old courthouse | the jail | the Washington County Courthouse | Hagerstown Community College"
Paterson: "the Paterson Museum | the old courthouse | the jail | the Passaic County Courthouse | the Great Falls National Historical Park"
Saratoga Springs: "the Saratoga Race Course | the old courthouse | the jail | the Saratoga County Courthouse | Skidmore College"
Poughkeepsie: "Vassar College | the old courthouse | the jail | the Dutchess County Courthouse | the Mid-Hudson Children's Museum"
Plattsburg: "the State University of New York at Plattsburgh | the old courthouse | the jail | the Clinton County Courthouse | the Kent-Delord House Museum"
Beaver Falls: "Geneva College | the old courthouse | the jail | the Beaver County Courthouse | the Beaver County Historical Research Center"
Altoona: "the Railroaders Memorial Museum | the old courthouse | the jail | the Blair County Courthouse | Penn State Altoona"
Williamsport: "the Thomas T. Taber Museum | the old courthouse | the jail | the Lycoming County Courthouse | Pennsylvania College of Technology"
Lancaster: "the Lancaster Central Market | the old courthouse | the jail | the Lancaster County Courthouse | Franklin & Marshall College"
Allentown: "the Allentown Art Museum | the old courthouse | the jail | the Lehigh County Courthouse | Muhlenberg College"
San Fernando: "San Fernando City Hall | the jail | the old courthouse | Local market | the central business district"
Brownsweg: "Central square | the old depot | Town center | Market area | Historic district"
Moengo: "Central square | the old depot | Town center | Market area | Historic buildings"
Nieuw Amsterdam: "Central square | the old depot | Town hall | Market area | Historic district"
Waterville: "Colby College | the old courthouse | the jail | the Kennebec County Superior Court | the Waterville Opera House"
Calais: "the St. Croix Island International Historic Site | the old courthouse | the jail | the Washington County Courthouse | the Calais Free Library"
Houlton: "the Aroostook County Historical Museum | the old courthouse | the jail | the Aroostook County Courthouse | the Market Square"
Benton Harbor: "the Krasl Art Center | the old courthouse | the jail | the Berrien County Courthouse | Lake Michigan Beach"
Battle Creek: "the Kellogg Company headquarters | the old courthouse | the jail | the Calhoun County Courthouse | Western Michigan University"
Bay City: "the Bay County Historical Museum | the old courthouse | the jail | the Bay County Courthouse | the Delta College Planetarium"
Alpena: "the Great Lakes Maritime Heritage Center | the old courthouse | the jail | the Alpena County Courthouse | Alpena Community College"
Iron Mountain: "the Menominee Range Historical Museum | the old courthouse | the jail | the Dickinson County Courthouse | Pine Mountain Ski Jump"
Ironwood: "the Ironwood Area Historical Society Museum | the old courthouse | the jail | the Gogebic County Courthouse | the World's Largest Hiawatha"
Sand Point: "Sand Point Airport | Central area | the old depot | the homeless shelter | Fishing harbor"
Hydaburg: "Central area | the old depot | the homeless shelter | Traditional totem poles | Fishing area"
Mekoryuk: "Central area | the old depot | the homeless shelter | Traditional buildings | Coastal area"
Atqasuk: "Central area | the old depot | the homeless shelter | Traditional buildings | Arctic landscape"
Port Heiden: "Central area | the old depot | the homeless shelter | Traditional buildings | Coastal area"
Perryville: "Central area | the old depot | the homeless shelter | Traditional buildings | Fishing area"
Dillingham: "Bristol Bay Campus | Central area | the old depot | the homeless shelter | Fishing harbor"
Goodnews Bay: "Central area | the old depot | the homeless shelter | Traditional buildings | Coastal area"
Nyac: "Central area | the old depot | the homeless shelter | Traditional buildings | Historic mining area"
Tununak: "Central area | the old depot | the homeless shelter | Traditional buildings | Coastal area"
Mountain Village: "Central area | the old depot | the homeless shelter | Traditional buildings | Yukon Delta area"
Emmonak: "Central area | the old depot | the homeless shelter | Traditional buildings | Fishing area"
Kaltag: "Central area | the old depot | the homeless shelter | Traditional buildings | Historic trading post"
Teller: "Central area | the old depot | the homeless shelter | Traditional buildings | Coastal area"
Koyukuk: "Central area | the old depot | the homeless shelter | Traditional buildings | Historic area"
Kobuk: "Central area | the old depot | the homeless shelter | Traditional buildings | Arctic area"
Selawik: "Central area | the old depot | the homeless shelter | Traditional buildings | Wildlife refuge area"
Talkeetna: "the Talkeetna Historical Society Museum | Central area | the old depot | the homeless shelter | Mountain views"
Whittier: "the Prince William Sound Museum | Central area | the homeless shelter | Begich Towers | Harbor area"
Montana: "Central area | the old depot | the homeless shelter | Traditional buildings | Remote wilderness"
Lake Minchumina: "Central area | the old depot | the homeless shelter | Traditional buildings | Lake area"
Cantwell: "Central area | the old depot | the homeless shelter | Traditional buildings | Denali area"
Gulkana: "Central area | the old depot | the homeless shelter | Traditional buildings | Historic roadhouse"
Eagle: "the Eagle Historical Society Museum | Central area | the old depot | the homeless shelter | Historic buildings"
Nenana: "the Nenana Ice Classic | Central area | the old depot | the homeless shelter | Historic railroad depot"
Big Delta: "Central area | the old depot | the homeless shelter | Traditional buildings | Historic roadhouse"
Allakaket: "Central area | the old depot | the homeless shelter | Traditional buildings | Arctic village"
Tanana: "Central area | the old depot | the homeless shelter | Traditional buildings | Historic trading post"
Vicente Guerrero: "Central Plaza | the old depot | Town hall | Market area | Historic district"
Loreto: "Mission San Javier | the old courthouse | Central Plaza | the Loreto Bay National Marine Park | Local market"
Ciudad Constitucion: "Central Plaza | the old depot | Town hall | Market area | Historic district"
Allende: "Central Plaza | the old depot | Town hall | Market area | Historic district"
Nueva Rosita: "Central Plaza | the old depot | Town hall | Market area | Historic district"
Hidalgo del Parral: "the Hidalgo Theater | the old courthouse | Central Plaza | the old depot | Mining museum"
Ascension: "Central Plaza | the old depot | Town hall | Market area | Historic district"
Gomez Palacio: "Central Plaza | the old depot | Town hall | Market area | Historic district"
Canatlan: "Central Plaza | the old depot | Town hall | Market area | Historic district"
Villa Union: "Central Plaza | the old depot | Town hall | Market area | Historic district"
Altata: "Central Plaza | the old depot | Coastal area | Market area | Fishing harbor"
Esperanza: "Central Plaza | the old depot | Town hall | Market area | Historic district"
Magdalena: "Central Plaza | the old depot | Town hall | Market area | Historic district"
Nacozari Viejo: "Central Plaza | the old depot | Town hall | Market area | Historic mining district"
Villanueva: "Central Plaza | the old depot | Town hall | Market area | Historic district"
Montemorelos: "Central Plaza | the old depot | Town hall | Market area | Historic district"
Sabinas Hidalgo: "Central Plaza | the old depot | Town hall | Market area | Historic district"
Cardenas: "Central Plaza | the old depot | Town hall | Market area | Historic district"
Ciudad Valles: "Central Plaza | the old depot | Town hall | Market area | Historic district"
Rio Verde: "Central Plaza | the old depot | Town hall | Market area | Historic district"
Ciudad Mante: "Central Plaza | the old depot | Town hall | Market area | Historic district"
Reynosa: "the the old courthouse | Central Plaza | the old depot | Market area | Border area"
Ciudad Madero: "Central Plaza | the old depot | Town hall | Market area | Refinery area"
Autlan: "Central Plaza | the old depot | Town hall | Market area | Historic district"
Ciudad Hidalgo: "Central Plaza | the old depot | Town hall | Market area | Historic district"
Apatzingan: "Central Plaza | the old depot | Town hall | Market area | Historic district"
Santiago Ixcuintla: "Central Plaza | the old depot | Town hall | Market area | Historic district"
Juchitan: "Central Plaza | the old depot | Town hall | Market area | Historic district"
Miahuatlan: "Central Plaza | the old depot | Town hall | Market area | Historic district"
Atlixco: "Central Plaza | the old depot | Town hall | Market area | Historic district"
Acatlan: "Central Plaza | the old depot | Town hall | Market area | Historic district"
Paraiso: "Central Plaza | the old depot | Town hall | Market area | Historic district"
Balancan: "Central Plaza | the old depot | Town hall | Market area | Historic district"
Tlaxcala: "the Tlaxcala Cathedral | the old courthouse | Central Plaza | the old depot | Government palace"
Irapuato: "Central Plaza | the old depot | Town hall | Market area | Historic district"
Celaya: "Central Plaza | the old depot | Town hall | Market area | Historic district"
Chilpancingo: "Central Plaza | the old depot | Town hall | Market area | Historic district"
Iguala: "Central Plaza | the old depot | Town hall | Market area | Historic district"
Tecpan: "Central Plaza | the old depot | Town hall | Market area | Historic district"
Atoyac: "Central Plaza | the old depot | Town hall | Market area | Coastal area"
Nezahualcoyotl: "Central Plaza | the old depot | Town hall | Market area | Urban area"
San Juan del Rio: "Central Plaza | the old depot | Town hall | Market area | Historic district"
Jaltipan: "Central Plaza | the old depot | Town hall | Market area | Historic district"
Orizaba: "the Orizaba Cathedral | the old courthouse | Central Plaza | the old depot | Government palace"
Xalapa: "the Xalapa Museum of Anthropology | the old courthouse | Central Plaza | University of Veracruz | Government palace"
Nautla: "Central Plaza | the old depot | Town hall | Market area | Coastal area"
San Cristobal de Las Casas: "the San Cristóbal Cathedral | the old courthouse | Central Plaza | the old depot | Indigenous markets"
Escuintla: "Central Plaza | the old depot | Town hall | Market area | Historic district"
Motul: "Central Plaza | the old depot | Town hall | Market area | Historic district"
Tekax: "Central Plaza | the old depot | Town hall | Market area | Historic district"
Peto: "Central Plaza | the old depot | Town hall | Market area | Historic district"
Halacho: "Central Plaza | the old depot | Town hall | Market area | Historic district"
Ciego de Avila: "the jail | the old depot | Town hall | Market area | Historic district"
Palma Soriano: "the jail | the old depot | Town hall | Market area | Historic district"
May Pen: "Central Square | Parish church | Town hall | Market area | Historic district"
Spanish Town: "the Spanish Town Cathedral | the old courthouse | Central Square | Parish church | Government buildings"
San Antonio de los Banos: "the jail | the old depot | Town hall | Market area | Historic district"
Guines: "the jail | the old depot | Town hall | Market area | Historic district"
Caibarien: "the jail | the old depot | Town hall | Market area | Coastal area"
Placetas: "the jail | the old depot | Town hall | Market area | Historic district"
Neiba: "the jail | the old depot | Town hall | Market area | Historic district"
La Vega: "the La Vega Cathedral | the old courthouse | the jail | the old depot | Government palace"
San Francisco de Macoris: "the jail | the old depot | Town hall | Market area | Historic district"
Selkirk: "the Marine Museum of Manitoba | the old courthouse | the jail | the Red River | Selkirk Park"
Berens River: "Central area | the old depot | the homeless shelter | Traditional buildings | Lakeside area"
Pukatawagan: "Central area | the old depot | the homeless shelter | Traditional buildings | Remote area"
Gimli: "the New Iceland Heritage Museum | the old courthouse | the jail | Gimli Beach | the Icelandic Festival grounds"
Island Lake: "Central area | the old depot | the homeless shelter | Traditional buildings | Island setting"
Melville: "the Melville Heritage Museum | the old courthouse | the jail | the Good Spirit Lake Regional Park | the Melville Golf & Country Club"
Weyburn: "the Soo Line Historical Museum | the old courthouse | the jail | the Weyburn Mental Health Centre | the Turner Curling Museum"
La Ronge: "the Northern Saskatchewan Trappers' Festival grounds | the old courthouse | the jail | La Ronge Community Centre | Lac la Ronge Provincial Park"
Stony Rapids: "Central area | the old depot | the homeless shelter | Traditional buildings | Northern wilderness"
Camrose: "the Camrose & District Centennial Museum | the old courthouse | the jail | the Bailey Theatre | University of Alberta Augustana Campus"
Hinton: "the Hinton Training Centre | the old courthouse | the jail | the Hinton Golf Club | Beaver Boardwalk"
Vegreville: "the World's Largest Pysanka | the old courthouse | the jail | the Vegreville Regional Museum | the Vegreville Golf Club"
Stettler: "the Stettler Town & Country Museum | the old courthouse | the jail | the Alberta Prairie Railway | the Stettler Recreation Centre"
Lac La Biche: "the Lac La Biche Mission | the old courthouse | the jail | Lac La Biche Provincial Park | the Portage College"
Wetaskiwin: "the Reynolds-Alberta Museum | the old courthouse | the jail | the Wetaskiwin & District Heritage Museum | the Wetaskiwin Golf Club"
Meander River: "Central area | the old depot | the homeless shelter | Traditional buildings | Remote area"
Creston: "the Creston Valley Wildlife Management Area | the old courthouse | the jail | the Creston Museum | the Columbia Brewery"
Cranbrook: "the Canadian Museum of Rail Travel | the old courthouse | the jail | the Key City Theatre | College of the Rockies"
Terrace: "the Heritage Park Museum | the old courthouse | the jail | the Terrace Little Theatre | Northwest Community College"
Chilliwack: "Cultus Lake | the old courthouse | the jail | the Chilliwack Museum | the University of the Fraser Valley"
Hall Beach: "Central area | the old depot | the homeless shelter | Traditional buildings | Arctic hamlet"
Lutselke: "Central area | the old depot | the homeless shelter | Traditional buildings | Great Slave Lake area"
Hay River: "the Hay River Museum | the old courthouse | the jail | the Hay River Golf Club | the Northern Frontier Visitors Centre"
Déline: "Central area | the old depot | the homeless shelter | Traditional buildings | Great Bear Lake area"
Paulatuk: "Central area | the old depot | the homeless shelter | Traditional buildings | Arctic coast"
Tsiigehtchic: "Central area | the old depot | the homeless shelter | Traditional buildings | Mackenzie Delta"
Owen Sound: "the Tom Thomson Art Gallery | the old courthouse | the jail | the Owen Sound Marine & Rail Museum | Georgian College"
Orillia: "the Stephen Leacock Museum | the old courthouse | the jail | the Orillia Opera House | Lakehead University Orillia"
Kapuskasing: "the Kapuskasing Museum | the old courthouse | the jail | the Ron Morel Memorial Museum | Northern College"
Thessalon: "the Thessalon Township Museum | the old courthouse | the jail | the Thessalon Marina | Algoma University"
Geraldton: "the Geraldton District Museum | the old courthouse | the jail | the Greenstone Building | Northern College"
Belleville: "the Glanmore National Historic Site | the old courthouse | the jail | the Empire Theatre | Loyalist College"
Sarnia: "the Sarnia Historical Museum | the old courthouse | the jail | the Imperial Theatre | Lambton College"
Peterborough: "Trent University | the old courthouse | the jail | the Canadian Canoe Museum | the Peterborough Museum & Archives"
Oshawa: "the Canadian Automotive Museum | the old courthouse | the jail | the Parkwood Estate | Durham College"
London: "the University of Western Ontario | the old courthouse | the jail | the Museum London | Fanshawe College"
Kitchener: "the Kitchener-Waterloo Art Gallery | the old courthouse | the jail | the Centre in the Square | University of Waterloo"
New Liskeard: "the Little Claybelt Homesteaders Museum | the old courthouse | the jail | the New Liskeard Golf Club | Northern College"
Brockville: "the Brockville Museum | the old courthouse | the jail | the Brockville Arts Centre | St. Lawrence College"
Big Beaver House: "Central area | the old depot | the homeless shelter | Traditional buildings | Remote area"
Port-Menier: "Central area | the old depot | the homeless shelter | Traditional buildings | Anticosti Island"
Riviere-du-Loup: "the Musée du Bas-Saint-Laurent | the old courthouse | the jail | the Théâtre du Bic | Cégep de Rivière-du-Loup"
Drummondville: "the Village Québécois d'Antan | the old courthouse | the jail | the Maison des Arts Desjardins | Cégep de Drummondville"
Sherbrooke: "the University of Sherbrooke | the old courthouse | the jail | the Musée de la Nature et des Sciences | Cégep de Sherbrooke"
Cap-Chat: "the Éole Wind Farm | the old courthouse | the jail | the Cap-Chat Lighthouse | Cégep de la Gaspésie"
Baie-Comeau: "the Jardin des Glaciers | the old courthouse | the jail | the Complexe Guy-Carbonneau | Cégep de Baie-Comeau"
Natashquan: "the Natashquan Museum | the old courthouse | the jail | the Natashquan Lighthouse | Traditional buildings"
Eastmain: "Central area | the old depot | the homeless shelter | Traditional buildings | James Bay area"
Schefferville: "the Schefferville Museum | the old courthouse | the jail | the Iron Ore Company facilities | Remote mining heritage"
Salluit: "Central area | the old depot | the homeless shelter | Traditional buildings | Arctic village"
Amos: "the Amos Museum | the old courthouse | the jail | the Amos Golf Club | Cégep de l'Abitibi-Témiscamingue"
Joliette: "the Musée d'art de Joliette | the old courthouse | the jail | the Amphithéâtre de Lanaudière | Cégep Joliette-De Lanaudière"
St.-Jerome: "the Musée d'art contemporain des Laurentides | the old courthouse | the jail | the Théâtre Gilles-Vigneault | Cégep de Saint-Jérôme"
St-Augustin: "Central area | the old depot | the homeless shelter | Traditional buildings | Lower North Shore"
Rouyn-Noranda: "the Musée de minéralogie et d'archéologie | the old courthouse | the jail | the Théâtre du cuivre | University of Quebec in Abitibi-Témiscamingue"
La Sarre: "the La Sarre Museum | the old courthouse | the jail | the La Sarre Golf Club | Cégep de l'Abitibi-Témiscamingue"
New Glasgow: "the New Glasgow Riverfront Jubilee Theatre | the old courthouse | the jail | the Nova Scotia Community College | the Carmichael Stewart House Museum"
Liverpool: "the Perkins House Museum | the old courthouse | the jail | the Queens County Museum | the Aspen Grove Hiking Trail"
Amherst: "the Cumberland County Museum | the old courthouse | the jail | the Amherst Golf Club | the Maritime Link Visitor Centre"
Baddeck: "the Alexander Graham Bell National Historic Site | the old courthouse | the jail | the Baddeck Marine | the Gaelic College"
Deer Lake: "the Deer Lake Museum | the old courthouse | the jail | the Deer Lake Golf Club | College of the North Atlantic"
La Scie: "Central area | the old depot | the homeless shelter | Traditional buildings | Coastal area"
Hopedale: "the Hopedale Mission National Historic Site | Central area | the old depot | the homeless shelter | Traditional buildings"
Happy Valley - Goose Bay: "the Labrador Military Museum | the old courthouse | the jail | the Labrador Institute | College of the North Atlantic"
Port Hope Simpson: "Central area | the old depot | the homeless shelter | Traditional buildings | Coastal area"
Tofino: "Chesterman Beach | the old courthouse | the jail | the Tofino Botanical Gardens | the Wickaninnish Inn"
Virginia: "the Iron Range Historical Society | the old courthouse | the jail | the Virginia Golf Club | the Olcott Park Fountain"
Winona: "Saint Mary's University of Minnesota | the old courthouse | the jail | the Winona County Historical Society | the Minnesota Marine Art Museum"
Rochester: "the Mayo Clinic | the old courthouse | the jail | Rochester Community and Technical College | the Plummer House"
Lakeville: "the Airlake Airport | the old courthouse | the jail | the Lakeville Arts Center | the Antlers Park"
Ely: "the International Wolf Center | the old courthouse | the jail | the Dorothy Molter Museum | Vermilion Community College"
Moorhead: "Minnesota State University Moorhead | the old courthouse | the jail | the Plains Art Museum | the Heritage Hjemkomst Interpretive Center"
St. Cloud: "St. Cloud State University | the old courthouse | the jail | the Stearns History Museum | the Paramount Center for the Arts"
Miles City: "the Range Riders Museum | the old courthouse | the jail | the Custer County Art & Heritage Center | Miles Community College"
Bozeman: "Montana State University | the old courthouse | the jail | the Museum of the Rockies | the Ellen Theatre"
Glasgow: "the Valley County Pioneer Museum | the old courthouse | the jail | the Glasgow Air Force Base | Fort Peck Dam"
Dickinson: "Dickinson State University | the old courthouse | the jail | the Dakota Dinosaur Museum | the Prairie Outpost Park"
Jamestown: "the University of Jamestown | the old courthouse | the jail | the National Buffalo Museum | the Jamestown Regional Airport"
Williston: "the Fort Union Trading Post | the old courthouse | the jail | the James Memorial Art Center | Williston State College"
Lihue: "the Kauai Museum | the old courthouse | the jail | the Lihue Airport | Kauai Community College"
Wahiawa: "the Wahiawa Botanical Garden | the old courthouse | the jail | the Kukaniloko Birthstones | the Wahiawa General Hospital"
Wailuku: "the Bailey House Museum | the old courthouse | the jail | the Maui Community College | the Wailuku Civic Center"
Montpelier: "Idaho State University Meridian | the old courthouse | the jail | the Bear Lake State Park | the Oregon Trail Center"
Twin Falls: "the Shoshone Falls | the old courthouse | the jail | the College of Southern Idaho | the Herrett Center for Arts & Science"
Caldwell: "the College of Idaho | the old courthouse | the jail | the Indian Creek Plaza | the Caldwell Fine Arts"
Salmon: "the Sacajawea Center | the old courthouse | the jail | the Salmon Valley Golf Club | the Lemhi County Historical Museum"
Coeur d'Alene: "Lake Coeur d'Alene | the old courthouse | the jail | the Museum of North Idaho | North Idaho College"
Richland: "the REACH Museum | the old courthouse | the jail | the Columbia Basin College | the Howard Amon Park"
Bellingham: "Western Washington University | the old courthouse | the jail | the Whatcom Museum | the Mount Baker Theatre"
Longview: "the Nutty Narrows Bridge | the old courthouse | the jail | the Lower Columbia College | the Monticello Hotel"
Walla Walla: "Whitman College | the old courthouse | the jail | the Fort Walla Walla Museum | Walla Walla Community College"
Aberdeen: "the Aberdeen Museum of History | the old courthouse | the jail | the Grays Harbor College | the D&R Theatre"
Bremerton: "the USS Turner Joy Museum Ship | the old courthouse | the jail | the Admiral Theatre | Olympic College"
Everett: "the Boeing Future of Flight Aviation Center | the old courthouse | the jail | the Everett Theatre | Everett Community College"
Bullhead City: "the Colorado River Museum | the old courthouse | the jail | the Mohave Community College | the Community Park"
Winslow: "the La Posada Hotel | the old courthouse | the jail | the Old Trails Museum | the Standin' on the Corner Park"
Gila Bend: "the Gila Bend Museum | the old courthouse | the jail | the Painted Rock Petroglyph Site | the Space Age Lodge"
Tombstone: "the OK Corral | the old courthouse | the jail | the Bird Cage Theatre | the Tombstone Courthouse State Historic Park"
Willcox: "the Rex Allen Museum | the old courthouse | the jail | the Willcox Golf Club | the Chiricahua Regional Museum"
Scottsdale: "the Scottsdale Museum of Contemporary Art | the old courthouse | the jail | the Scottsdale Center for the Performing Arts | Scottsdale Community College"
Kingman: "the Mohave Museum of History and Arts | the old courthouse | the jail | the Powerhouse Visitor Center | the Kingman Railroad Museum"
Grand Canyon: "the Grand Canyon National Park | the old courthouse | the jail | the Grand Canyon Railway | the Kolb Studio"
Arcata: "Humboldt State University | the old courthouse | the jail | the Arcata Community Forest | the Humboldt Bay Maritime Museum"
Stockton: "the University of the Pacific | the old courthouse | the jail | the Haggin Museum | the Bob Hope Theatre"
Barstow: "the Route 66 Mother Road Museum | the old courthouse | the jail | the Barstow Community College | the Desert Discovery Center"
Victorville: "the California Route 66 Museum | the old courthouse | the jail | the Victor Valley College | the Mojave Narrows Regional Park"
Pasadena: "the Rose Bowl | the old courthouse | the jail | the California Institute of Technology | Pasadena City College"
Visalia: "the ImagineU Interactive Children's Museum | the old courthouse | the jail | the College of the Sequoias | the Visalia Fox Theatre"
El Centro: "the Imperial Valley College | the old courthouse | the jail | the Pioneers Museum | the Bucklin Park"
San Luis Obispo: "California Polytechnic State University | the old courthouse | the jail | the San Luis Obispo Museum of Art | Cuesta College"
Merced: "the University of California Merced | the old courthouse | the jail | the Merced County Courthouse Museum | Merced College"
Yuba City: "the Community Memorial Museum | the old courthouse | the jail | the Yuba College | the Sutter County Courthouse"
Redding: "the Turtle Bay Exploration Park | the old courthouse | the jail | the Shasta College | the Cascade Theatre"
Santa Rosa: "the Charles M. Schulz Museum | the old courthouse | the jail | the Santa Rosa Junior College | the Luther Burbank Home & Gardens"
Oceanside: "the California Surf Museum | the old courthouse | the jail | the MiraCosta College | the Oceanside Museum of Art"
Modesto: "the McHenry Mansion | the old courthouse | the jail | the Modesto Junior College | the Gallo Center for the Arts"
Irvine: "the University of California Irvine | the old courthouse | the jail | the Irvine Museum | the Irvine Valley College"
Ukiah: "the Grace Hudson Museum | the old courthouse | the jail | the Mendocino College | the Alex Thomas Plaza"
Needles: "the Needles Regional Museum | the old courthouse | the jail | the Old Trails Bridge | the Carty Trask Freedom Park"
Bishop: "the Eastern Sierra Museum | the old courthouse | the jail | the Cerro Coso Community College | the Bishop City Park"
Palm Springs: "the Palm Springs Art Museum | the old courthouse | the jail | the College of the Desert | the Indian Canyons"
Santa Maria: "the Santa Maria Museum of Flight | the old courthouse | the jail | the Allan Hancock College | the Santa Maria Civic Theatre"
Tulare: "the Tulare Historical Museum | the old courthouse | the jail | the Tulare Golf Club | the International Agri-Center"
Mt. Shasta: "Mount Shasta | the old courthouse | the jail | the Sisson Museum | the College of the Siskiyous"
Crescent City: "the Battery Point Lighthouse | the old courthouse | the jail | the Del Norte County Historical Society | College of the Redwoods"
Fort Collins: "Colorado State University | the old courthouse | the jail | the Discovery Science Center | the Fort Collins Museum of Art"
Pueblo: "the Pueblo Riverwalk | the old courthouse | the jail | Colorado State University Pueblo | the Sangre de Cristo Arts Center"
Lamar: "the Big Timbers Museum | the old courthouse | the jail | Lamar Community College | the Cow Palace Inn"
Trinidad: "the Trinidad History Museum | the old courthouse | the jail | Trinidad State Junior College | the A.R. Mitchell Museum"
Gunnison: "Western State Colorado University | the old courthouse | the jail | the Pioneer Museum | the Gunnison Arts Center"
Durango: "the Durango & Silverton Narrow Gauge Railroad | the old courthouse | the jail | Fort Lewis College | the Animas Museum"
Montrose: "the Museum of the Mountain West | the old courthouse | the jail | the Montrose County Historical Museum | Colorado Mesa University Montrose"
Craig: "the Museum of Northwest Colorado | the old courthouse | the jail | Colorado Northwestern Community College | the Sandstone Cellars Winery"
Boulder: "the University of Colorado Boulder | the old courthouse | the jail | the Boulder Museum of Contemporary Art | the Flatirons"
Boulder City: "the Boulder City/Hoover Dam Museum | the old courthouse | the jail | the Boulder Theatre | the Nevada State Railroad Museum"
Winnemucca: "the Humboldt Museum | the old courthouse | the jail | the Winners Casino | the Martin Hotel"
Roswell: "the International UFO Museum | the old courthouse | the jail | the New Mexico Military Institute | Eastern New Mexico University"
Clovis: "the Norman Petty Studios | the old courthouse | the jail | Clovis Community College | the Hillcrest Park Zoo"
Las Cruces: "New Mexico State University | the old courthouse | the jail | the Las Cruces Museum of Art | Doña Ana Community College"
Hobbs: "the Western Heritage Museum | the old courthouse | the jail | the University of the Southwest | Lea County Courthouse"
Socorro: "the New Mexico Institute of Mining and Technology | the old courthouse | the jail | the Socorro Mission | the Mineral Museum"
Gallup: "the Red Rock Museum | the old courthouse | the jail | the University of New Mexico Gallup | the El Morro Theatre"
Raton: "the Raton Museum | the old courthouse | the jail | the Shuler Theater | the Historic First Street"
Tucumcari: "the Mesalands Community College's Dinosaur Museum | the old courthouse | the jail | the Tucumcari Historical Museum | the Blue Swallow Motel"
Roseburg: "the Douglas County Museum | the old courthouse | the jail | Umpqua Community College | the Wildlife Safari"
Pendleton: "the Pendleton Round-Up | the old courthouse | the jail | Blue Mountain Community College | the Tamástslikt Cultural Institute"
John Day: "the Kam Wah Chung State Heritage Site | the old courthouse | the jail | the Grant County Historical Museum | the John Day Fossil Beds"
Grants Pass: "the Rogue River | the old courthouse | the jail | Rogue Community College | the Schmidt House Museum"
Corvallis: "Oregon State University | the old courthouse | the jail | the Corvallis Arts Center | the Benton County Historical Society"
Albany: "the Albany Historic Carousel & Museum | the old courthouse | the jail | Linn-Benton Community College | the Albany Regional Museum"
Astoria: "the Columbia River Maritime Museum | the old courthouse | the jail | the Astoria Column | Clatsop Community College"
Logan: "Utah State University | the old courthouse | the jail | the Ellen Eccles Theatre | the American West Heritage Center"
Parowan: "the Parowan Gap Petroglyphs | the old courthouse | the jail | Southern Utah University Cedar City | the Iron Mission State Park"
Kanab: "the Best Friends Animal Sanctuary | the old courthouse | the jail | the Little Hollywood Movie Museum | the Kanab Heritage Museum"
Monticello: "the Frontier Museum | the old courthouse | the jail | the San Juan County Courthouse | the Monticello Golf Club"
Moab: "Arches National Park | the old courthouse | the jail | the Moab Information Center | the Red Cliffs Lodge"
Price: "the USU Eastern Prehistoric Museum | the old courthouse | the jail | Utah State University Eastern | the Price Municipal Airport"
Cedar City: "Southern Utah University | the old courthouse | the jail | the Utah Shakespeare Festival | the Frontier Homestead State Park Museum"
Vernal: "the Utah Field House of Natural History | the old courthouse | the jail | Utah State University Uintah Basin | the Dinosaur National Monument"
Ogden: "the Union Station | the old courthouse | the jail | Weber State University | the Eccles Community Art Center"
Green River: "the Sweetwater County Historical Museum | the old courthouse | the jail | Western Wyoming Community College | the Expedition Island Park"
Rawlins: "the Wyoming Frontier Prison Museum | the old courthouse | the jail | Western Wyoming Community College | the Carbon County Museum"
Douglas: "the Wyoming Pioneer Memorial Museum | the old courthouse | the jail | the Douglas Railroad Interpretive Center | Converse County Courthouse"
Riverton: "the Riverton Museum | the old courthouse | the jail | Central Wyoming College | the Wind River Heritage Center"
Thermopolis: "the Wyoming Dinosaur Center | the old courthouse | the jail | the Hot Springs State Park | the Hot Springs County Museum"
Gillette: "the Rockpile Museum | the old courthouse | the jail | the Campbell County Public Library | the Cam-plex Multi-Event Facilities"
Jonesboro: "Arkansas State University | the old courthouse | the jail | the Craighead County Courthouse | the Forrest L. Wood Crowley's Ridge Nature Center"
Texarkana: "the Perot Theatre | the old courthouse | the jail | Texarkana College | the Discovery Place Interactive Museum"
Pine Bluff: "the Arkansas Railroad Museum | the old courthouse | the jail | the University of Arkansas at Pine Bluff | Jefferson County Courthouse"
Hot Springs: "Hot Springs National Park | the old courthouse | the jail | National Park College | the Bathhouse Row"
Fort Smith: "the Fort Smith National Historic Site | the old courthouse | the jail | the University of Arkansas at Fort Smith | the Fort Smith Museum of History"
Fayetteville: "the University of Arkansas | the old courthouse | the jail | the Walton Arts Center | the Northwest Arkansas Mall"
Conway: "Hendrix College | the old courthouse | the jail | the University of Central Arkansas | the Faulkner County Museum"
El Dorado: "the South Arkansas Arts Center | the old courthouse | the jail | South Arkansas Community College | the Union County Courthouse"
Davenport: "the Figge Art Museum | the old courthouse | the jail | St. Ambrose University | the River Music Experience"
Burlington: "the Des Moines County Heritage Center | the old courthouse | the jail | Southeastern Community College | the Capitol Theater"
Dubuque: "the University of Dubuque | the old courthouse | the jail | the National Mississippi River Museum | Clarke University"
Waterloo: "the University of Northern Iowa | the old courthouse | the jail | the Grout Museum District | Hawkeye Community College"
Sioux City: "the Sioux City Public Museum | the old courthouse | the jail | Morningside College | Western Iowa Tech Community College"
Council Bluffs: "the Union Pacific Railroad Museum | the old courthouse | the jail | Iowa Western Community College | the Squirrel Cage Jail"
Ames: "Iowa State University | the old courthouse | the jail | the Brunnier Art Museum | the Reiman Gardens"
Mason City: "the Music Man Square | the old courthouse | the jail | North Iowa Area Community College | the Historic Park Inn Hotel"
Emporia: "Emporia State University | the old courthouse | the jail | the Red Rocks State Historic Site | the Lyon County Historical Museum"
Salina: "Kansas State University Salina | the old courthouse | the jail | the Smoky Hill Museum | the Salina Art Center"
Dodge City: "the Boot Hill Museum | the old courthouse | the jail | Dodge City Community College | the Santa Fe Trail"
Coffeyville: "the Coffeyville Historical Museum | the old courthouse | the jail | Coffeyville Community College | the Dalton Defenders Museum"
St. Charles: "the Lewis & Clark Boat House and Museum | the old courthouse | the jail | Lindenwood University | the Historic Main Street"
Poplar Bluff: "the Margaret Harwell Art Museum | the old courthouse | the jail | Three Rivers Community College | the Black River Coliseum"
Joplin: "Missouri Southern State University | the old courthouse | the jail | the Joplin Museum Complex | the George A. Spiva Center for the Arts"
Columbia: "the University of Missouri | the old courthouse | the jail | Columbia College | the Museum of Art and Archaeology"
St. Joseph: "the Pony Express National Museum | the old courthouse | the jail | Missouri Western State University | the Jesse James Home Museum"
McCook: "the High Plains Museum | the old courthouse | the jail | McCook Community College | the Frank House"
Norfolk: "the Elkhorn Valley Museum | the old courthouse | the jail | Northeast Community College | the Norfolk Arts Center"
North Platte: "the Buffalo Bill Ranch State Historical Park | the old courthouse | the jail | Mid-Plains Community College | the Lincoln County Historical Museum"
Sidney: "the Fort Sidney Museum | the old courthouse | the jail | Western Nebraska Community College | the Cheyenne County Museum"
Scottsbluff: "Scotts Bluff National Monument | the old courthouse | the jail | Western Nebraska Community College | the Legacy of the Plains Museum"
Chadron: "Chadron State College | the old courthouse | the jail | the Museum of the Fur Trade | the Dawes County Historical Society Museum"
Lawton: "the Museum of the Great Plains | the old courthouse | the jail | Cameron University | Fort Sill"
Norman: "the University of Oklahoma | the old courthouse | the jail | the Fred Jones Jr. Museum of Art | the Oklahoma Geological Survey"
Muskogee: "the Five Civilized Tribes Museum | the old courthouse | the jail | Connors State College | the USS Batfish"
Ponca City: "the Marland Estate Mansion | the old courthouse | the jail | Northern Oklahoma College | the Ponca City Art Association"
Shawnee: "the Mabee-Gerrer Museum of Art | the old courthouse | the jail | Oklahoma Baptist University | the Shawnee Municipal Airport"
Woodward: "the Plains Indians and Pioneers Museum | the old courthouse | the jail | Northwestern Oklahoma State University | the Crystal Beach Park"
Guymon: "the No Man's Land Historical Museum | the old courthouse | the jail | Oklahoma Panhandle State University | the Guymon Golf & Country Club"
Yankton: "the Dakota Territorial Museum | the old courthouse | the jail | Mount Marty College | the Missouri National Recreational River"
Brookings: "South Dakota State University | the old courthouse | the jail | the South Dakota Art Museum | the McCrory Gardens"
Mitchell: "the Corn Palace | the old courthouse | the jail | Dakota Wesleyan University | the Prehistoric Indian Village"
Aberdeen: "Northern State University | the old courthouse | the jail | the Dacotah Prairie Museum | the Aberdeen Recreation & Cultural Center"
Mobridge: "the Klein Museum | the old courthouse | the jail | the Sitting Bull Monument | the Mobridge Country Club"
Houma: "the Southdown Plantation House | the old courthouse | the jail | Fletcher Technical Community College | the Terrebonne Parish Courthouse"
Monroe: "the University of Louisiana at Monroe | the old courthouse | the jail | the Biedenharn Museum & Gardens | Louisiana Delta Community College"
Conroe: "the Heritage Museum of Montgomery County | the old courthouse | the jail | Lone Star College Montgomery | the Crighton Theatre"
Nacogdoches: "Stephen F. Austin State University | the old courthouse | the jail | the Stone Fort Museum | the Millard's Crossing Historic Village"
Eagle Pass: "the Fort Duncan Museum | the old courthouse | the jail | Southwest Texas Junior College | the Maverick County Courthouse"
Edinburg: "the University of Texas Rio Grande Valley | the old courthouse | the jail | the Museum of South Texas History | South Texas College"
Kingsville: "Texas A&M University-Kingsville | the old courthouse | the jail | the King Ranch Museum | the Conner Museum"
Port Arthur: "the Museum of the Gulf Coast | the old courthouse | the jail | Lamar State College Port Arthur | the Sabine Pass Battleground"
Huntsville: "Sam Houston State University | the old courthouse | the jail | the Sam Houston Memorial Museum | the Texas Prison Museum"
Killeen: "Central Texas College | the old courthouse | the jail | the Mayborn Science Theater | the 1st Cavalry Division Museum"
Lufkin: "Angelina College | the old courthouse | the jail | the Texas Forestry Museum | the Museum of East Texas"
Del Rio: "the Whitehead Memorial Museum | the old courthouse | the jail | Sul Ross State University Rio Grande College | the Val Verde County Courthouse"
San Angelo: "Angelo State University | the old courthouse | the jail | the San Angelo Museum of Fine Arts | the Fort Concho National Historic Landmark"
Sherman: "Austin College | the old courthouse | the jail | the Sherman Museum | the Grayson College"
Beaumont: "Lamar University | the old courthouse | the jail | the Spindletop-Gladys City Boomtown Museum | the Art Museum of Southeast Texas"
Bay City: "the Bay City Historical Museum | the old courthouse | the jail | the Matagorda County Courthouse | the Bay City Civic Center"
Port Lavaca: "the Calhoun County Museum | the old courthouse | the jail | the Calhoun County Courthouse | the Half Moon Reef Lighthouse"
Falfurrias: "the Heritage Museum | the old courthouse | the jail | the Brooks County Courthouse | the Falfurrias Butter Company"
Beeville: "the Beeville Art Museum | the old courthouse | the jail | Coastal Bend College | the Bee County Courthouse"
Fort Stockton: "the Historic Fort Stockton | the old courthouse | the jail | the Pecos County Courthouse | the Annie Riggs Memorial Museum"
Pecos: "the West of the Pecos Museum | the old courthouse | the jail | the Reeves County Courthouse | the Maxey Park"
Dumas: "the Window on the Plains Museum | the old courthouse | the jail | the Moore County Courthouse | the McDade Park"
Denton: "the University of North Texas | the old courthouse | the jail | Texas Woman's University | the Courthouse-on-the-Square Museum"
Midland: "the Petroleum Museum | the old courthouse | the jail | the University of Texas of the Permian Basin | the Midland County Courthouse"
Temple: "the Temple Railroad & Heritage Museum | the old courthouse | the jail | Temple College | the Cultural Activities Center"
New Haven: "Yale University | the old courthouse | the jail | the Peabody Museum of Natural History | the Shubert Theatre"
Lowell: "the Lowell National Historical Park | the old courthouse | the jail | the University of Massachusetts Lowell | the Merrimack Repertory Theatre"
Worcester: "the Worcester Art Museum | the old courthouse | the jail | Worcester Polytechnic Institute | the Hanover Theatre"
Manchester: "the Currier Museum of Art | the old courthouse | the jail | the University of New Hampshire at Manchester | the Palace Theatre"
Newport: "the Newport Mansions | the old courthouse | the jail | Salve Regina University | the International Tennis Hall of Fame"
Dothan: "the Wiregrass Museum of Art | the old courthouse | the jail | Wallace Community College | the Dothan Opera House"
Tuscaloosa: "the University of Alabama | the old courthouse | the jail | the Paul W. Bryant Museum | Stillman College"
Gadsden: "the Mary G. Hardin Center for Cultural Arts | the old courthouse | the jail | Gadsden State Community College | the Coosa County Courthouse"
Enterprise: "the Boll Weevil Monument | the old courthouse | the jail | Enterprise State Community College | the Coffee County Courthouse"
Selma: "the Edmund Pettus Bridge | the old courthouse | the jail | Concordia College Alabama | the Selma to Montgomery National Historic Trail"
Coral Gables: "the University of Miami | the old courthouse | the jail | the Coral Gables Museum | the Venetian Pool"
Cape Coral: "the Cape Coral Historical Museum | the old courthouse | the jail | the Cultural Park Theatre | the Cape Coral Yacht Club"
Naples: "the Naples Pier | the old courthouse | the jail | the Baker Museum | the Naples Botanical Garden"
Fort Pierce: "the Manatee Observation & Education Center | the old courthouse | the jail | Indian River State College | the St. Lucie County Historical Museum"
Kissimmee: "the Old Town entertainment district | the old courthouse | the jail | Valencia College | the Osceola County Stadium"
Titusville: "the Kennedy Space Center Visitor Complex | the old courthouse | the jail | Eastern Florida State College | the American Space Museum"
St. Augustine: "the Castillo de San Marcos | the old courthouse | the jail | Flagler College | the Lightner Museum"
Ocala: "the Appleton Museum of Art | the old courthouse | the jail | the College of Central Florida | Silver Springs State Park"
Fort Lauderdale: "Las Olas Boulevard | the old courthouse | the jail | Nova Southeastern University | the Broward Center for the Performing Arts"
Apalachicola: "the Apalachicola Maritime Museum | the old courthouse | the jail | the John Gorrie Museum | the Trinity Episcopal Church"
Vero Beach: "the Vero Beach Museum of Art | the old courthouse | the jail | Indian River State College | the McKee Botanical Garden"
Valdosta: "Valdosta State University | the old courthouse | the jail | the Lowndes County Historical Society | Wild Adventures Theme Park"
Albany: "Albany State University | the old courthouse | the jail | the Albany Museum of Art | the Flint RiverQuarium"
Athens: "the University of Georgia | the old courthouse | the jail | the Georgia Museum of Art | the State Botanical Garden of Georgia"
Macon: "Mercer University | the old courthouse | the jail | the Tubman Museum | the Ocmulgee Mounds National Historical Park"
Columbus: "Columbus State University | the old courthouse | the jail | the Columbus Museum | the National Infantry Museum"
Douglas: "South Georgia State College | the old courthouse | the jail | the Coffee County Arts Center | the General Coffee State Park"
Dublin: "the Dublin-Laurens Museum | the old courthouse | the jail | the Theatre Dublin | the Shamrock Festival grounds"
Gulfport: "the Gulfport Harbor | the old courthouse | the jail | Mississippi Gulf Coast Community College | the Jones Park"
Hattiesburg: "the University of Southern Mississippi | the old courthouse | the jail | the Hattiesburg Zoo | the Mississippi Armed Forces Museum"
Tupelo: "the Elvis Presley Birthplace | the old courthouse | the jail | the Northeast Mississippi Community College | the Tupelo Automobile Museum"
Greenville: "the Mississippi River | the old courthouse | the jail | the Mississippi Delta Community College | the B.B. King Museum"
Natchez: "the Natchez National Historical Park | the old courthouse | the jail | Copiah-Lincoln Community College | the Natchez Under-the-Hill"
Florence: "Francis Marion University | the old courthouse | the jail | the Florence County Museum | the Florence Little Theatre"
Greenville: "Bob Jones University | the old courthouse | the jail | the Greenville County Museum of Art | the Peace Center"
Sumter: "the Swan Lake Iris Gardens | the old courthouse | the jail | the University of South Carolina Sumter | the Sumter County Museum"
Anderson: "Anderson University | the old courthouse | the jail | the Anderson County Museum | the Civic Center of Anderson"
Aiken: "the University of South Carolina Aiken | the old courthouse | the jail | the Aiken County Historical Museum | the Thoroughbred Racing Hall of Fame"
Beaufort: "the University of South Carolina Beaufort | the old courthouse | the jail | the Beaufort History Museum | the Henry C. Chambers Waterfront Park"
Rock Hill: "Winthrop University | the old courthouse | the jail | the Museum of York County | the Rock Hill Arts Council"
Decatur: "Millikin University | the old courthouse | the jail | the Macon County Museum Complex | the Scovill Zoo"
Alton: "Lewis and Clark Community College | the old courthouse | the jail | the Alton Museum of History and Art | the National Great Rivers Museum"
Quincy: "Quincy University | the old courthouse | the jail | the Gardner Museum of Architecture | the Quincy Art Center"
Urbana: "the University of Illinois | the old courthouse | the jail | the Krannert Art Museum | the Spurlock Museum"
Bloomington: "Illinois State University | the old courthouse | the jail | the McLean County Museum of History | the Children's Discovery Museum"
Kankakee: "Kankakee Community College | the old courthouse | the jail | the Kankakee County Museum | the B. Harley Bradley House"
Waukegan: "the Genesee Theatre | the old courthouse | the jail | the College of Lake County | the Waukegan History Museum"
Aurora: "Aurora University | the old courthouse | the jail | the Paramount Theatre | the SciTech Hands-On Museum"
Carbondale: "Southern Illinois University | the old courthouse | the jail | the University Museum | the Shryock Auditorium"
Belleville: "Southwestern Illinois College | the old courthouse | the jail | the St. Clair County Historical Society | the Labor & Industry Museum"
Bloomington: "Indiana University | the old courthouse | the jail | the Monroe County History Center | the WonderLab Museum"
Muncie: "Ball State University | the old courthouse | the jail | the Minnetrista Museum | the National Model Aviation Museum"
Kokomo: "Indiana University Kokomo | the old courthouse | the jail | the Howard County Historical Museum | the Seiberling Mansion"
Gary: "Indiana University Northwest | the old courthouse | the jail | the Gary SouthShore RailCats stadium | the Miller Beach Arts & Creative District"
Fort Wayne: "the University of Saint Francis | the old courthouse | the jail | the Fort Wayne Museum of Art | the Embassy Theatre"
Covington: "the Carnegie Center for Art & History | the old courthouse | the jail | Northern Kentucky University | the Roebling Suspension Bridge"
Bowling Green: "Western Kentucky University | the old courthouse | the jail | the National Corvette Museum | the Historic RailPark"
Paducah: "the National Quilt Museum | the old courthouse | the jail | West Kentucky Community and Technical College | the Market House Theatre"
Owensboro: "the Owensboro Museum of Fine Art | the old courthouse | the jail | Kentucky Wesleyan College | the International Bluegrass Music Museum"
Jacksonville: "the Lejeune Memorial Gardens | the old courthouse | the jail | Coastal Carolina Community College | the Onslow County Museum"
Goldsboro: "the Wayne County Museum | the old courthouse | the jail | Wayne Community College | the Paramount Theatre"
Greenville: "East Carolina University | the old courthouse | the jail | the Greenville Museum of Art | the Mendenhall Plantation"
Fayetteville: "Fort Bragg | the old courthouse | the jail | Fayetteville State University | the Airborne & Special Operations Museum"
Hickory: "Lenoir-Rhyne University | the old courthouse | the jail | the Hickory Museum of Art | the Catawba Science Center"
Asheville: "the University of North Carolina at Asheville | the old courthouse | the jail | the Asheville Art Museum | the Thomas Wolfe Memorial"
Winston-Salem: "Wake Forest University | the old courthouse | the jail | the Reynolda House Museum of American Art | the Southeastern Center for Contemporary Art"
Kitty Hawk: "the Wright Brothers National Memorial | the old courthouse | the jail | the Outer Banks History Center | the Nags Head Woods Preserve"
Akron: "the University of Akron | the old courthouse | the old Goodyear factory | the Akron Art Museum | Stan Hywet Hall"
Lima: "the University of Northwestern Ohio | the old courthouse | the jail | the Allen County Museum | the Lima Symphony Orchestra"
Oak Ridge: "the American Museum of Science & Energy | the old courthouse | the jail | the Oak Ridge Art Center | the Children's Museum of Oak Ridge"
Murfreesboro: "Middle Tennessee State University | the old courthouse | the jail | the Discovery Center | the Oaklands Mansion"
Clarksville: "Austin Peay State University | the old courthouse | the jail | the Customs House Museum | the Roxy Regional Theatre"
Jackson: "Union University | the old courthouse | the jail | the Casey Jones Home & Railroad Museum | the West Tennessee Delta Heritage Center"
Alexandria: "George Washington Masonic National Memorial | the old courthouse | the jail | Northern Virginia Community College | the Torpedo Factory Art Center"
Fredericksburg: "the University of Mary Washington | the old courthouse | the jail | the Fredericksburg Battlefield | the Rising Sun Tavern"
Roanoke: "the Taubman Museum of Art | the old courthouse | the jail | Virginia Western Community College | the Center in the Square"
Danville: "the Danville Science Center | the old courthouse | the jail | Danville Community College | the Danville Museum of Fine Arts"
Winchester: "Shenandoah University | the old courthouse | the jail | the Museum of the Shenandoah Valley | the Handley Regional Library"
Bristol: "the Birthplace of Country Music Museum | the old courthouse | the jail | Virginia Highlands Community College | the Paramount Center for the Arts"
Superior: "the University of Wisconsin-Superior | the old courthouse | the jail | the Richard I. Bong Veterans Historical Center | the Fairlawn Mansion"
West Bend: "the University of Wisconsin-Washington County | the old courthouse | the jail | the Museum of Wisconsin Art | the Eisenbahn State Trail"
Fond du Lac: "Marian University | the old courthouse | the jail | the Fond du Lac County Historical Society | the Thelma Sadoff Center for the Arts"
Oshkosh: "the University of Wisconsin Oshkosh | the old courthouse | the jail | the Paine Art Center and Gardens | the EAA Aviation Museum"
Rhinelander: "Nicolet Area Technical College | the old courthouse | the jail | the Rhinelander Logging Museum | the Pioneer Park Historical Complex"
Racine: "the Racine Art Museum | the old courthouse | the jail | the University of Wisconsin-Parkside | the SC Johnson headquarters"
Marinette: "the Marinette County Historical Museum | the old courthouse | the jail | Northeast Wisconsin Technical College | the Menominee Marina"
Wheeling: "Wheeling Jesuit University | the old courthouse | the jail | the Oglebay Institute | the Capitol Music Hall"
Morgantown: "West Virginia University | the old courthouse | the jail | the West Virginia Botanic Garden | the Monongalia Arts Center"
Huntington: "Marshall University | the old courthouse | the jail | the Huntington Museum of Art | the Keith-Albee Performing Arts Center"
Beckley: "the University of Charleston | the old courthouse | the jail | the Tamarack Arts Center | the Raleigh County Courthouse"
Wilmington: "the University of Delaware | the old courthouse | the jail | the Delaware Art Museum | the Grand Opera House"
Cumberland: "Allegany College of Maryland | the old courthouse | the jail | the C&O Canal National Historical Park | the Embassy Theatre"
Atlantic City: "the Atlantic City Boardwalk | the old courthouse | the jail | Stockton University | the Steel Pier"
Newark: "Rutgers University-Newark | the old courthouse | the jail | the Newark Museum of Art | the New Jersey Performing Arts Center"
Schenectady: "Union College | the old courthouse | the jail | the Schenectady Museum | Proctors Theatre"
Binghamton: "Binghamton University | the old courthouse | the jail | the Roberson Museum and Science Center | the Chenango Valley State Park"
Utica: "the Munson-Williams-Proctor Arts Institute | the old courthouse | the jail | Mohawk Valley Community College | the Stanley Center for the Arts"
Watertown: "Jefferson Community College | the old courthouse | the jail | the Jefferson County Historical Society | the Salmon Run Mall"
Niagara Falls: "Niagara Falls State Park | the old courthouse | the jail | Niagara University | the Cave of the Winds"
Jamestown: "Jamestown Community College | the old courthouse | the jail | the National Comedy Center | the Robert H. Jackson Center"
Elmira: "Elmira College | the old courthouse | the jail | the Chemung County Historical Society | the Elmira Corning Regional Airport"
York: "York College of Pennsylvania | the old courthouse | the jail | the York County History Center | the Appell Center for the Performing Arts"
Johnstown: "the University of Pittsburgh at Johnstown | the old courthouse | the jail | the Johnstown Flood Museum | the Pasquerilla Performing Arts Center"
Scranton: "the University of Scranton | the old courthouse | the jail | the Everhart Museum | the Electric City Trolley Museum"
State College: "Pennsylvania State University | the old courthouse | the jail | the Palmer Museum of Art | the Penn State All-Sports Museum"
Erie: "Gannon University | the old courthouse | the jail | the Erie Art Museum | the Bicentennial Tower"
Wilkes Barre: "Wilkes University | the old courthouse | the jail | the Luzerne County Museum | the F.M. Kirby Center"
Nieuw Nickerie: "Central square | the old depot | Town hall | Market area | Coastal area"
Brokopondo: "Central square | the old depot | Town hall | Market area | Historic district"
Totness: "Central square | the old depot | Town hall | Market area | Historic plantation area"
Bar Harbor: "Acadia National Park | the old courthouse | the jail | the College of the Atlantic | the Abbe Museum"
Lewiston: "Bates College | the old courthouse | the jail | the Bates Mill Complex | the Public Theatre"
Presque Isle: "the University of Maine at Presque Isle | the old courthouse | the jail | the Northern Maine Museum of Science | the Aroostook Centre Mall"
Ann Arbor: "the University of Michigan | the old courthouse | the jail | the University of Michigan Museum of Art | the Michigan Theater"
Kalamazoo: "Western Michigan University | the old courthouse | the jail | the Kalamazoo Institute of Arts | the Air Zoo"
Muskegon: "Baker College | the old courthouse | the jail | the Muskegon Museum of Art | the USS Silversides Submarine Museum"
Flint: "the University of Michigan-Flint | the old courthouse | the jail | the Flint Institute of Arts | the Longway Planetarium"
Grand Rapids: "Grand Valley State University | the old courthouse | the jail | the Grand Rapids Art Museum | the Frederik Meijer Gardens"
Pontiac: "Oakland University | the old courthouse | the jail | the Pontiac Creative Arts Center | the Phoenix Center"
Cadillac: "Baker College of Cadillac | the old courthouse | the jail | the Cadillac Heritage Nature Study Area | the Wexford County Historical Museum"
Traverse City: "Northwestern Michigan College | the old courthouse | the jail | the National Cherry Festival grounds | the Grand Traverse Commons"
Petoskey: "the Little Traverse History Museum | the old courthouse | the jail | North Central Michigan College | the Petoskey State Park"
Escanaba: "Bay de Noc Community College | the old courthouse | the jail | the Delta County Historical Museum | the Ludington Park"
Marquette: "Northern Michigan University | the old courthouse | the jail | the Marquette Regional History Center | the DeVos Art Museum"
Hancock: "Michigan Technological University | the old courthouse | the jail | the Quincy Mine | the Finnish American Heritage Center"
Wrangell: "the Wrangell Museum | the old courthouse | the jail | the Chief Shakes Island | Petroglyph Beach State Historic Park"
Shishmaref: "Central area | the old depot | the homeless shelter | Traditional buildings | Coastal erosion area"
Hoonah: "the Hoonah Cultural Center | Central area | the old depot | the homeless shelter | Icy Strait Point"
Atka: "Central area | the old depot | the homeless shelter | Traditional buildings | Aleutian village"
Nikolski: "Central area | the old depot | the homeless shelter | Traditional buildings | Umnak Island"
Karluk: "Central area | the old depot | the homeless shelter | Traditional buildings | Kodiak Island village"
False Pass: "Central area | the old depot | the homeless shelter | Traditional buildings | Fishing village"
Kivalina: "Central area | the old depot | the homeless shelter | Traditional buildings | Arctic coastal village"
Newhalen: "Central area | the old depot | the homeless shelter | Traditional buildings | Bristol Bay area"
Pilot Point: "Central area | the old depot | the homeless shelter | Traditional buildings | Alaska Peninsula"
Chignik: "Central area | the old depot | the homeless shelter | Traditional buildings | Fishing village"
King Salmon: "Central area | the old depot | the homeless shelter | Traditional buildings | Bristol Bay hub"
Quinhagak: "Central area | the old depot | the homeless shelter | Traditional buildings | Yukon Delta village"
Aniak: "Central area | the old depot | the homeless shelter | Traditional buildings | Kuskokwim village"
Kotlik: "Central area | the old depot | the homeless shelter | Traditional buildings | Yukon Delta village"
Unalakleet: "Central area | the old depot | the homeless shelter | Traditional buildings | Norton Sound village"
Koyuk: "Central area | the old depot | the homeless shelter | Traditional buildings | Seward Peninsula village"
McGrath: "Central area | the old depot | the homeless shelter | Traditional buildings | Interior Alaska hub"
Hughes: "Central area | the old depot | the homeless shelter | Traditional buildings | Koyukuk village"
Ambler: "Central area | the old depot | the homeless shelter | Traditional buildings | Arctic village"
Wales: "Central area | the old depot | the homeless shelter | Traditional buildings | Westernmost mainland village"
Kotzebue: "the Northwest Arctic Heritage Center | Central area | the old depot | the homeless shelter | Arctic hub"
Wasilla: "the Iditarod Trail Sled Dog Race headquarters | the old courthouse | the jail | Wasilla Lake | the Museum of Alaska Transportation"
Circle: "Central area | the old depot | the homeless shelter | Traditional buildings | Yukon village"
Denali Park: "Denali National Park entrance | Central area | the homeless shelter | Traditional buildings | Wilderness area"
Yakutat: "Central area | the old depot | the homeless shelter | Traditional buildings | Coastal glacial area"
Homer: "the Homer Spit | the old courthouse | the jail | the Pratt Museum | the Alaska Islands & Ocean Visitor Center"
Tanacross: "Central area | the old depot | the homeless shelter | Traditional buildings | Interior village"
Wiseman: "Central area | the old depot | the homeless shelter | Traditional buildings | Historic mining town"
Les Cayes: "the jail | the old depot | Town hall | Market area | Coastal area"
Gonaives: "the jail | the old depot | Town hall | Market area | Historic district"
San Quintin: "Central Plaza | the old depot | Town hall | Market area | Agricultural area"
Punta Prieta: "Central Plaza | the old depot | Town hall | Market area | Desert area"
San Felipe: "Central Plaza | the old depot | Town hall | Market area | Coastal area"
Santa Rosalia: "the Iglesia de Santa Bárbara | the old courthouse | Central Plaza | the old depot | Mining heritage area"
Guerrero Negro: "Central Plaza | the old depot | Town hall | Market area | Salt production area"
Piedras Negras: "Central Plaza | the old depot | Town hall | Market area | Border city"
San Pedro de las Colonias: "Central Plaza | the old depot | Town hall | Market area | Historic district"
Sierra Mojada: "Central Plaza | the old depot | Town hall | Market area | Mining town"
Parras: "Central Plaza | the old depot | Town hall | Market area | Wine region"
Cuauhtemoc: "Central Plaza | the old depot | Town hall | Market area | Mennonite community area"
Nuevo Casas Grandes: "Central Plaza | the old depot | Town hall | Market area | Archaeological area"
Ojinaga: "Central Plaza | the old depot | Town hall | Market area | Border town"
Villa Ahumada: "Central Plaza | the old depot | Town hall | Market area | Historic district"
Santa Barbara: "Central Plaza | the old depot | Town hall | Market area | Historic district"
Ciudad Camargo: "Central Plaza | the old depot | Town hall | Market area | Historic district"
Cuencame: "Central Plaza | the old depot | Town hall | Market area | Historic district"
Papasquiaro: "Central Plaza | the old depot | Town hall | Market area | Historic district"
Escuinapa: "Central Plaza | the old depot | Town hall | Market area | Coastal area"
Guamuchil: "Central Plaza | the old depot | Town hall | Market area | Historic district"
Guasave: "Central Plaza | the old depot | Town hall | Market area | Agricultural area"
El Fuerte: "Central Plaza | the old depot | Town hall | Market area | Historic colonial town"
Eldorado: "Central Plaza | the old depot | Town hall | Market area | Historic district"
La Cruz: "Central Plaza | the old depot | Town hall | Market area | Coastal area"
Agua Prieta: "Central Plaza | the old depot | Town hall | Market area | Border town"
Ciudad Obregon: "Central Plaza | the old depot | Town hall | Market area | Agricultural center"
Navajoa: "Central Plaza | the old depot | Town hall | Market area | Historic district"
Caborca: "Central Plaza | the old depot | Town hall | Market area | Desert town"
Mazatlán: "Central Plaza | the old depot | Town hall | Market area | Historic district"
Cananea: "Central Plaza | the old depot | Town hall | Market area | Mining town"
Huatabampo: "Central Plaza | the old depot | Town hall | Market area | Coastal area"
Zacatecas: "the Zacatecas Cathedral | the old courthouse | Central Plaza | the old depot | UNESCO World Heritage site"
Juan Aldama: "Central Plaza | the old depot | Town hall | Market area | Historic district"
Valparaiso: "Central Plaza | the old depot | Town hall | Market area | Historic district"
Fresnillo: "Central Plaza | the old depot | Town hall | Market area | Mining town"
Linares: "Central Plaza | the old depot | Town hall | Market area | Historic district"
Matehuala: "Central Plaza | the old depot | Town hall | Market area | Historic district"
Tamuin: "Central Plaza | the old depot | Town hall | Market area | Historic district"
Tamazunchale: "Central Plaza | the old depot | Town hall | Market area | Historic district"
Tula: "Central Plaza | the old depot | Town hall | Market area | Historic district"
Aldama: "Central Plaza | the old depot | Town hall | Market area | Historic district"
San Fernando: "Central Plaza | the old depot | Town hall | Market area | Historic district"
Tecoman: "Central Plaza | the old depot | Town hall | Market area | Coastal area"
Puerto Vallarta: "the Malecón boardwalk | the old courthouse | Central Plaza | the old depot | Beach resort area"
La Barca: "Central Plaza | the old depot | Town hall | Market area | Historic district"
Ciudad Guzman: "Central Plaza | the old depot | Town hall | Market area | Historic district"
Lagos de Moreno: "Central Plaza | the old depot | Town hall | Market area | Historic colonial town"
Morelia: "the Morelia Cathedral | the old courthouse | Central Plaza | University of Michoacán | UNESCO World Heritage site"
Lazaro Cardenas: "Central Plaza | the old depot | Town hall | Market area | Port city"
Zamora: "Central Plaza | the old depot | Town hall | Market area | Historic district"
Coalcoman: "Central Plaza | the old depot | Town hall | Market area | Historic district"
Uruapan: "Central Plaza | the old depot | Town hall | Market area | Avocado capital"
Tuxpan: "Central Plaza | the old depot | Town hall | Market area | Historic district"
Tepic: "Central Plaza | the old depot | Town hall | Market area | Historic district"
Compostela: "Central Plaza | the old depot | Town hall | Market area | Historic district"
Tecuala: "Central Plaza | the old depot | Town hall | Market area | Historic district"
Ciudad del Carmen: "Central Plaza | the old depot | Town hall | Market area | Island city"
Champoton: "Central Plaza | the old depot | Town hall | Market area | Coastal area"
Salina Cruz: "Central Plaza | the old depot | Town hall | Market area | Pacific port"
Puerto Escondido: "Central Plaza | the old depot | Town hall | Market area | Surfing destination"
Pochutla: "Central Plaza | the old depot | Town hall | Market area | Coastal area"
Mitla: "the Mitla archaeological site | Central Plaza | the old depot | Town hall | Zapotec ruins"
Tlaxiaco: "Central Plaza | the old depot | Town hall | Market area | Historic district"
Huajuapan de Leon: "Central Plaza | the old depot | Town hall | Market area | Historic district"
Tehuacan: "Central Plaza | the old depot | Town hall | Market area | Historic district"
Teziutlan: "Central Plaza | the old depot | Town hall | Market area | Historic district"
Frontera: "Central Plaza | the old depot | Town hall | Market area | Historic district"
Tenosique: "Central Plaza | the old depot | Town hall | Market area | Historic district"
Salamanca: "Central Plaza | the old depot | Town hall | Market area | Historic district"
Guanajuato: "the University of Guanajuato | the old courthouse | Central Plaza | the Alhóndiga de Granaditas | UNESCO World Heritage site"
Taxco: "the Santa Prisca Church | the old courthouse | Central Plaza | Silver mines | UNESCO World Heritage site"
Ayutla: "Central Plaza | the old depot | Town hall | Market area | Historic district"
Ciudad Altamirano: "Central Plaza | the old depot | Town hall | Market area | Historic district"
Petatlan: "Central Plaza | the old depot | Town hall | Market area | Coastal area"
Pachuca: "the Pachuca Cathedral | the old courthouse | Central Plaza | the old depot | Mining heritage"
Toluca: "Central Plaza | the old depot | Town hall | Market area | Historic district"
Zumpango: "Central Plaza | the old depot | Town hall | Market area | Historic district"
Minatitlan: "Central Plaza | the old depot | Town hall | Market area | Refinery city"
Coatzacoalcos: "Central Plaza | the old depot | Town hall | Market area | Port city"
Poza Rica de Hidalgo: "Central Plaza | the old depot | Town hall | Market area | Oil city"
Cordoba: "Central Plaza | the old depot | Town hall | Market area | Historic district"
Santiago Tuxtla: "Central Plaza | the old depot | Town hall | Market area | Historic district"
Tuxpam: "Central Plaza | the old depot | Town hall | Market area | Port city"
Panuco: "Central Plaza | the old depot | Town hall | Market area | Historic district"
Pijijiapan: "Central Plaza | the old depot | Town hall | Market area | Coastal area"
Isla Mujeres: "Central Plaza | the old depot | Town hall | Market area | Island paradise"
Felipe Carrillo Puerto: "Central Plaza | the old depot | Town hall | Market area | Historic district"
Tizimin: "Central Plaza | the old depot | Town hall | Market area | Historic district"
Valladolid: "the San Servacio Cathedral | the old courthouse | Central Plaza | the old depot | Colonial architecture"
Izamal: "the Convent of San Antonio de Padua | the old courthouse | Central Plaza | the old depot | Yellow city"
Ticul: "Central Plaza | the old depot | Town hall | Market area | Pottery town"
Cienfuegos: "the jail | the old depot | Town hall | Market area | Historic district"
Nueva Gerona: "the jail | the old depot | Town hall | Market area | Island capital"
Sancti Spiritus: "the jail | the old depot | Town hall | Market area | Historic district"
Moron: "the jail | the old depot | Town hall | Market area | Historic district"
Nuevitas: "the jail | the old depot | Town hall | Market area | Port city"
Manzanillo: "the jail | the old depot | Town hall | Market area | Port city"
Bayamo: "the jail | the old depot | Town hall | Market area | Historic district"
Banes: "the jail | the old depot | Town hall | Market area | Historic district"
Las Tunas: "the jail | the old depot | Town hall | Market area | Historic district"
San Pedro de Macoris: "the jail | the old depot | Town hall | Market area | Sugar town"
Artemisa: "the jail | the old depot | Town hall | Market area | Historic district"
Matanzas: "the jail | the old depot | Town hall | Market area | Historic district"
Colon: "the jail | the old depot | Town hall | Market area | Historic district"
Sagua la Grande: "the jail | the old depot | Town hall | Market area | Historic district"
Monte Cristi: "the jail | the old depot | Town hall | Market area | Coastal area"
Barahona: "the jail | the old depot | Town hall | Market area | Coastal area"
Bavaro: "Beach resorts | Central area | the old depot | Market area | Tourist zone"
Steinbach: "the Mennonite Heritage Village | the old courthouse | the jail | the Steinbach Arts Council | Southeast Collegiate"
Nelson House: "Central area | the old depot | the homeless shelter | Traditional buildings | Northern Manitoba"
Shamattawa: "Central area | the old depot | the homeless shelter | Traditional buildings | First Nations community"
Oxford House: "Central area | the old depot | the homeless shelter | Traditional buildings | Cree Nation"
Yorkton: "the Western Development Museum | the old courthouse | the jail | Yorkton Regional High School | the Gallagher Centre"
Swift Current: "the Chinook Parkway | the old courthouse | the jail | Southwest Saskatchewan Cultural Centre | Great Plains College"
Biggar: "the Biggar Museum & Gallery | the old courthouse | the jail | the Land of the Living Skies Museum | Central West Community College"
Kindersley: "the Kindersley Museum | the old courthouse | the jail | the West Central Events Centre | Great Plains College"
Meadow Lake: "the Meadow Lake Museum | the old courthouse | the jail | the Flying Dust First Nation Cultural Centre | Northwest Regional College"
Hudson Bay: "the Hudson Bay Museum | the old courthouse | the jail | the Hudson Bay Regional Park | Carlton Trail College"
Lethbridge: "the University of Lethbridge | the old courthouse | the jail | the Galt Museum & Archives | Lethbridge College"
Brooks: "the Brooks Aqueduct | the old courthouse | the jail | Medicine Hat College Brooks Campus | the Brooks Golf Club"
Lake Louise: "Lake Louise | the old courthouse | the jail | the Chateau Lake Louise | the Lake Louise Ski Resort"
Athabasca: "Athabasca University | the old courthouse | the jail | the Athabasca Golf & Country Club | the Athabasca Landing Trail"
Fort Chipewyan: "Central area | the old depot | the homeless shelter | Traditional buildings | Wood Buffalo National Park"
Bella Bella: "Central area | the old depot | the homeless shelter | Traditional buildings | Heiltsuk Nation"
Sandspit: "Central area | the old depot | the homeless shelter | Traditional buildings | Haida Gwaii"
Campbell River: "the Museum at Campbell River | the old courthouse | the jail | North Island College | the Maritime Heritage Centre"
Port Hardy: "the Port Hardy Museum | the old courthouse | the jail | North Island College | the Quatse Salmon Stewardship Centre"
Nanaimo: "Vancouver Island University | the old courthouse | the jail | the Nanaimo Museum | the Bastion"
Quesnel: "the Quesnel Museum | the old courthouse | the jail | the College of New Caledonia | the West Fraser Timber Co. Museum"
Abbotsford: "the University of the Fraser Valley | the old courthouse | the jail | the Reach Gallery Museum | the Abbotsford Centre"
Dawson Creek: "the Dawson Creek Art Gallery | the old courthouse | the jail | Northern Lights College | Mile 0 of the Alaska Highway"
Penticton: "the Penticton Museum | the old courthouse | the jail | Okanagan College | the South Okanagan Events Centre"
Nelson: "the Touchstones Museum | the old courthouse | the jail | Selkirk College | the Capitol Theatre"
Lillooet: "the Lillooet Museum | the old courthouse | the jail | the Mile 0 Cairn | the Old Bridge"
Powell River: "the Powell River Historical Museum | the old courthouse | the jail | Vancouver Island University | the Powell River Academy of Music"
Revelstoke: "the Revelstoke Museum | the old courthouse | the jail | the Revelstoke Railway Museum | Okanagan College"
Burns Lake: "the Burns Lake Museum | the old courthouse | the jail | the College of New Caledonia | the Lakes District Museum"
Dease Lake: "Central area | the old depot | the homeless shelter | Traditional buildings | Northern BC wilderness"
Coral Harbour: "Central area | the old depot | the homeless shelter | Traditional buildings | Nunavut hamlet"
Baker Lake: "Central area | the old depot | the homeless shelter | Traditional buildings | Geographical center of Canada"
Norman Wells: "Central area | the old depot | the homeless shelter | Traditional buildings | Oil town"
Fort McPherson: "Central area | the old depot | the homeless shelter | Traditional buildings | Gwich'in community"
Burwash Landing: "Central area | the old depot | the homeless shelter | Traditional buildings | Kluane National Park area"
Orangeville: "the Orangeville Opera House | the old courthouse | the jail | the Dufferin County Museum | the Theatre Orangeville"
Little Current: "the Centennial Museum of Sheguiandah | the old courthouse | the jail | the Little Current Swing Bridge | the Debajehmujig Theatre"
Chapleau: "the Chapleau Museum | the old courthouse | the jail | the Chapleau Game Preserve | the Chapleau Crown Game Preserve"
Wawa: "the Wawa Goose Monument | the old courthouse | the jail | the Michipicoten River Village | the Young's General Store Museum"
Hearst: "the Université de Hearst | the old courthouse | the jail | the Mattice-Val Côté Museum | the Claude Larose Recreation Centre"
Marathon: "the Marathon Museum | the old courthouse | the jail | the Peninsula Resort | the Neys Provincial Park"
Sioux Lookout: "the Sioux Lookout Museum | the old courthouse | the jail | the Ojibway Power Toboggan Company | the Hudson Museum"
Red Lake: "the Red Lake Regional Heritage Centre | the old courthouse | the jail | the Red Lake Margaret Cochenour Memorial Hospital | the Howey Bay Recreation Centre"
Deer Lake: "Central area | the old depot | the homeless shelter | Traditional buildings | Northern Ontario"
Cat Lake: "Central area | the old depot | the homeless shelter | Traditional buildings | First Nations community"
Cornwall: "the Cornwall Community Museum | the old courthouse | the jail | St. Lawrence College | the Aultsville Hall"
Kingston: "Queen's University | the old courthouse | the jail | the Royal Military College of Canada | Fort Henry"
Barrie: "the MacLaren Art Centre | the old courthouse | the jail | Georgian College | the Barrie Community Sports Complex"
Parry Sound: "the West Parry Sound District Museum | the old courthouse | the jail | the Charles W. Stockey Centre | Canadore College"
Wiarton: "the Wiarton Willie Festival grounds | the old courthouse | the jail | the Bruce Peninsula National Park | the Chi-Cheemaun ferry terminal"
Cobalt: "the Cobalt Mining Museum | the old courthouse | the jail | the Classic Theatre | the Cobalt Railway Station"
Cochrane: "the Cochrane Polar Bear Habitat | the old courthouse | the jail | the Tim Horton Museum | Northern College"
Nipigon: "the Nipigon Museum | the old courthouse | the jail | the Red Rock Marina | the Nipigon River Recreation Centre"
Atikokan: "the Atikokan Centennial Museum | the old courthouse | the jail | the Quetico Provincial Park | the Atikokan Economic Development Corporation"
Rimouski: "the Université du Québec à Rimouski | the old courthouse | the jail | the Musée régional de Rimouski | the Cégep de Rimouski"
Saint-Georges: "the Centre culturel Marie-Fitzbach | the old courthouse | the jail | the Cégep Beauce-Appalaches | the Maison J.A. Vachon"
Victoriaville: "the Cégep de Victoriaville | the old courthouse | the jail | the Musée Laurier | the Colisée Desjardins"
Chevery: "Central area | the old depot | the homeless shelter | Traditional buildings | Lower North Shore"
Mistassini: "Central area | the old depot | the homeless shelter | Traditional buildings | James Bay Cree community"
Kangirsuk: "Central area | the old depot | the homeless shelter | Traditional buildings | Nunavik village"
Shawinigan: "the Cité de l'Énergie | the old courthouse | the jail | the Université du Québec à Trois-Rivières campus | the Centre des arts de Shawinigan"
Matagami: "Central area | the old depot | the homeless shelter | Traditional buildings | Mining town"
Mont-Laurier: "the Cégep de Saint-Jérôme campus | the old courthouse | the jail | the Centre d'exposition de Mont-Laurier | the Complexe sportif"
Pembroke: "the Champlain Trail Museum | the old courthouse | the jail | the Algonquin College Pembroke Campus | the Pembroke Memorial Centre"
Radisson: "Central area | the old depot | the homeless shelter | Traditional buildings | Hydro-Québec town"
Saint John: "the University of New Brunswick Saint John | the old courthouse | the jail | the New Brunswick Museum | the Imperial Theatre"
Edmundston: "the Université de Moncton campus | the old courthouse | the jail | the Madawaska Historical Museum | the Centre des arts et de la culture"
Shelburne: "the Shelburne County Museum | the old courthouse | the jail | the Shelburne Historic Waterfront | the Historic Dock Street Theatre"
Antigonish: "St. Francis Xavier University | the old courthouse | the jail | the Antigonish Heritage Museum | the Bauer Theatre"
Windsor: "the Windsor Hockey Heritage Centre | the old courthouse | the jail | the Howard Dill Enterprises | the West Hants Historical Society Museum"
Digby: "the Digby Pines Golf Resort | the old courthouse | the jail | the Admiral Digby Museum | the Trinity Anglican Church"
Stephenville: "the Stephenville Theatre Festival | the old courthouse | the jail | the College of the North Atlantic | the Harmon Field"
Argentia: "the Argentia Naval Base | the old courthouse | the jail | the Heart's Content Cable Station | the Placentia West Heritage Committee"
St. Anthony: "the Grenfell Historic Properties | the old courthouse | the jail | the College of the North Atlantic | the Grenfell Interpretation Centre"
Channel-Port aux Basques: "the Railway Heritage Centre | the old courthouse | the jail | the College of the North Atlantic | the J.T. Cheeseman Provincial Park"
Buchans: "the Buchans Mining Museum | the old courthouse | the jail | the Red Indian Lake | the Mary March Regional Museum"
Trout River: "Central area | the old depot | the homeless shelter | Traditional buildings | Gros Morne National Park"
Churchill Falls: "Central area | the old depot | the homeless shelter | Traditional buildings | Hydroelectric facility"
Forteau: "Central area | the old depot | the homeless shelter | Traditional buildings | Labrador Straits"
Ponce: "the Ponce Museum of Art | the old courthouse | the jail | the Catholic University of Puerto Rico | the Parque de Bombas"
Mayaguez: "the University of Puerto Rico at Mayagüez | the old courthouse | the jail | the Mayagüez Zoo | the Coliseo Rafael A. Mangual"
George Town: "the Cayman Islands National Museum | the old courthouse | the jail | the Cayman Islands Legislative Assembly | the George Town Public Library"
Willemstad: "the Handelskade | the old courthouse | the jail | the University of Curaçao | the Floating Market"
Oranjestad: "the Archaeological Museum of Aruba | the old courthouse | the jail | the University of Aruba | the Fort Zoutman"
La Romana: "Casa de Campo Resort | the old courthouse | the jail | the Altos de Chavón | the Marina Casa de Campo"
Trepassey: "Central area | the old depot | the homeless shelter | Traditional buildings | Avalon Peninsula"
Kailua-Kona: "Kailua Pier | the old courthouse | the jail | the Hulihee Palace | the Mokuaikaua Church"
Butte: "the Berkeley Pit | the old courthouse | the jail | Montana Tech | the World Museum of Mining"
Grand Forks: "the University of North Dakota | the old courthouse | the jail | the North Dakota Museum of Art | the Alerus Center"
Pocatello: "Idaho State University | the old courthouse | the jail | the Pocatello Zoo | the Museum of Clean"
Tacoma: "the University of Puget Sound | the old courthouse | the jail | the Tacoma Art Museum | the Museum of Glass"
Yuma: "the Castle Dome Museum | the old courthouse | the jail | Arizona Western College | the Sanguinetti House Museum"
Prescott: "the Sharlot Hall Museum | the old courthouse | the jail | Embry-Riddle Aeronautical University | the Prescott Center for the Arts"
Long Beach: "the Queen Mary | the old courthouse | the jail | California State University Long Beach | the Aquarium of the Pacific"
Grand Junction: "Colorado Mesa University | the old courthouse | the jail | the Museum of the West | the Avalon Theatre"
Ely: "the Nevada Northern Railway Museum | the old courthouse | the jail | the White Pine Public Museum | the Hotel Nevada"
Carson City: "the Nevada State Museum | the old courthouse | the jail | Western Nevada College | the Nevada State Capitol"
Carlsbad: "the Carlsbad Caverns National Park | the old courthouse | the jail | the New Mexico State University Carlsbad | the Pecos River Flume"
Alamogordo: "the International UFO Museum | the old courthouse | the jail | New Mexico State University Alamogordo | the Tularosa Basin Historical Society Museum"
Medford: "Southern Oregon University | the old courthouse | the jail | the Craterian Theater | Rogue Community College"
Klamath Falls: "Oregon Institute of Technology | the old courthouse | the jail | the Klamath County Museum | the Ross Ragland Theater"
St. George: "Dixie State University | the old courthouse | the jail | the St. George Utah Temple | the Tuacahn Center for the Arts"
Provo: "Brigham Young University | the old courthouse | the jail | the BYU Museum of Art | Utah Valley University"
Laramie: "the University of Wyoming | the old courthouse | the jail | the University of Wyoming Art Museum | the Wyoming Territorial Prison State Historic Site"
Little Rock: "the University of Arkansas at Little Rock | the old courthouse | the jail | the Arkansas Arts Center | the William J. Clinton Presidential Center"
Wichita: "Wichita State University | the old courthouse | the jail | the Wichita Art Museum | the Sedgwick County Zoo"
Jefferson City: "Lincoln University | the old courthouse | the jail | the Missouri State Capitol | the Missouri State Penitentiary"
Rapid City: "the South Dakota School of Mines and Technology | the old courthouse | the jail | the Journey Museum | the Dahl Arts Center"
Lafayette: "the University of Louisiana at Lafayette | the old courthouse | the jail | the Acadiana Center for the Arts | the Lafayette Science Museum"
Galveston: "the University of Texas Medical Branch | the old courthouse | the jail | the Galveston Island Historic Pleasure Pier | the Strand Historic District"
Freeport: "the Brazosport Museum of Natural Science | the old courthouse | the jail | Brazosport College | the Freeport Historical Museum"
Victoria: "the University of Houston-Victoria | the old courthouse | the jail | the Museum of the Coastal Bend | the Victoria Regional Airport"
Odessa: "the University of Texas of the Permian Basin | the old courthouse | the jail | the Presidential Archives and Leadership Library | the Ellen Noel Art Museum"
Wichita Falls: "Midwestern State University | the old courthouse | the jail | the Wichita Falls Museum of Art | the Multi-Purpose Events Center"
Waco: "Baylor University | the old courthouse | the jail | the Texas Sports Hall of Fame | the Dr Pepper Museum"
Lubbock: "Texas Tech University | the old courthouse | the jail | the Buddy Holly Center | the National Ranching Heritage Center"
Hartford: "Trinity College | the old courthouse | the jail | the Wadsworth Atheneum | the Connecticut Science Center"
Providence: "Brown University | the old courthouse | the jail | the Rhode Island School of Design Museum | the Trinity Repertory Company"
Birmingham: "the University of Alabama at Birmingham | the old courthouse | the jail | the Birmingham Museum of Art | the Alabama Theatre"
Mobile: "the University of South Alabama | the old courthouse | the jail | the Mobile Museum of Art | the Historic Oakleigh Mansion"
Pensacola: "the University of West Florida | the old courthouse | the jail | the National Naval Aviation Museum | the Pensacola Museum of Art"
St. Petersburg: "the University of South Florida St. Petersburg | the old courthouse | the jail | the Salvador Dalí Museum | the Museum of Fine Arts"
Biloxi: "the University of Southern Mississippi Gulf Coast | the old courthouse | the jail | the Biloxi Lighthouse | the Mississippi Aquarium"
Springfield: "the University of Illinois Springfield | the old courthouse | the jail | the Abraham Lincoln Presidential Library | the Illinois State Museum"
Frankfort: "Kentucky State University | the old courthouse | the jail | the Kentucky History Center | the Old State Capitol"
Greensboro: "the University of North Carolina at Greensboro | the old courthouse | the jail | the Greensboro Science Center | the Weatherspoon Art Museum"
Dayton: "the University of Dayton | the old courthouse | the jail | the National Museum of the United States Air Force | the Dayton Art Institute"
Virginia Beach: "Old Dominion University | the old courthouse | the jail | the Virginia Aquarium | the Military Aviation Museum"
Madison: "the University of Wisconsin-Madison | the old courthouse | the jail | the Chazen Museum of Art | the Wisconsin State Capitol"
Green Bay: "the University of Wisconsin-Green Bay | the old courthouse | the jail | the National Railroad Museum | the Neville Public Museum"
Trenton: "the New Jersey State Museum | the old courthouse | the jail | Thomas Edison State University | the Old Barracks Museum"
Lansing: "Michigan State University | the old courthouse | the jail | the Michigan History Center | the Impression 5 Science Center"
Gambell: "Central area | the old depot | the homeless shelter | Traditional buildings | St. Lawrence Island"
Palmer: "the Palmer Museum of History and Art | the old courthouse | the jail | Alaska Pacific University | the Alaska State Fair grounds"
Seward: "the Alaska SeaLife Center | the old courthouse | the jail | the Seward Community Library | the Exit Glacier"
Cap-Haitien: "the Citadelle Laferrière | the old courthouse | the jail | the Sans-Souci Palace | the Cathedral of Cap-Haïtien"
Ensenada: "the Cultural Center of Ensenada | the old courthouse | Central Plaza | the Autonomous University of Baja California | the Ensenada Wine Route"
Saltillo: "the Saltillo Cathedral | the old courthouse | Central Plaza | the Autonomous University of Coahuila | the Desert Museum"
Ciudad Juárez: "the Chamizal National Memorial | the old courthouse | Central Plaza | the Autonomous University of Ciudad Juárez | the Museum of the Revolution"
Delicias: "Central Plaza | the old depot | Town hall | Market area | Agricultural center"
Durango: "the Durango Cathedral | the old courthouse | Central Plaza | the Juárez University of Durango | the Francisco Villa Museum"
Los Mochis: "Central Plaza | the old depot | Town hall | Market area | the Chepe Railway station"
Ciudad Victoria: "Central Plaza | the old depot | Town hall | Market area | the Autonomous University of Tamaulipas"
Aguascalientes: "the San Marcos Fair grounds | the old courthouse | Central Plaza | the Autonomous University of Aguascalientes | the José Guadalupe Posada Museum"
Manzanillo: "Central Plaza | the old depot | Town hall | Market area | Port facilities"
Tehuantepec: "Central Plaza | the old depot | Town hall | Market area | the Isthmus cultural center"
Villahermosa: "the La Venta Museum | the old courthouse | Central Plaza | the Juárez Autonomous University of Tabasco | the Tomás Garrido Canabal Park"
Cuernavaca: "the Palace of Cortés | the old courthouse | Central Plaza | the Autonomous University of Morelos | the Robert Brady Museum"
Queretaro: "the Historic Center | the old courthouse | Central Plaza | the Autonomous University of Querétaro | UNESCO World Heritage site"
Tapachula: "Central Plaza | the old depot | Town hall | Market area | Border city with Guatemala"
Chetumal: "the Museum of Mayan Culture | the old courthouse | Central Plaza | the University of Quintana Roo | the Chetumal Bay"
Progreso: "the Progreso Pier | the old courthouse | Central Plaza | the old depot | Coastal resort"
Pinar del Rio: "the jail | the old depot | Town hall | Market area | Tobacco region"
Camaguey: "the Historic Center | the old courthouse | the jail | the University of Camagüey | UNESCO World Heritage site"
Guantanamo: "the jail | the old depot | Town hall | Market area | Historic district"
Holguin: "the the jail | the old courthouse | the jail | the University of Holguín | the La Periquera Museum"
Montego Bay: "Doctor's Cave Beach | the old courthouse | Central Square | the Hip Strip | the Rose Hall Great House"
Santa Clara: "the Che Guevara Mausoleum | the old courthouse | the jail | the Central University of Las Villas | the Leoncio Vidal Park"
Duluth: "the University of Minnesota Duluth | the old courthouse | the jail | the Great Lakes Aquarium | the Duluth Entertainment Convention Center"
Bemidji: "Bemidji State University | the old courthouse | the jail | the Headwaters Science Center | the Paul Bunyan and Babe statues"
Havre: "Montana State University-Northern | the old courthouse | the jail | the H. Earl Clack Museum | the Havre Beneath the Streets"
Kalispell: "the Conrad Mansion Museum | the old courthouse | the jail | Flathead Valley Community College | the Hockaday Museum of Art"
Idaho Falls: "the Museum of Idaho | the old courthouse | the jail | the College of Eastern Idaho | the Idaho Falls Zoo"
Lewiston: "Lewis-Clark State College | the old courthouse | the jail | the Nez Perce County Historical Society | the Lewiston Civic Theatre"
Yakima: "the Yakima Valley Museum | the old courthouse | the jail | Central Washington University | the Capitol Theatre"
Wenatchee: "the Wenatchee Valley Museum | the old courthouse | the jail | Wenatchee Valley College | the Numerica Performing Arts Center"
Douglas: "the Douglas Historical Museum | the old courthouse | the jail | Cochise College | the Slaughter Ranch Museum"
Bakersfield: "California State University Bakersfield | the old courthouse | the jail | the Bakersfield Museum of Art | the Fox Theater"
Oakland: "the University of California Berkeley | the old courthouse | the jail | the Oakland Museum of California | the Fox Oakland Theatre"
Lancaster: "the Antelope Valley College | the old courthouse | the jail | the Museum of Art and History | the Lancaster Performing Arts Center"
Chico: "California State University Chico | the old courthouse | the jail | the National Yo-Yo Museum | the Chico Museum"
Monterey: "the Monterey Bay Aquarium | the old courthouse | the jail | the Monterey Peninsula College | the Monterey Jazz Festival grounds"
Salinas: "the National Steinbeck Center | the old courthouse | the jail | Hartnell College | the California Rodeo grounds"
Los Alamos: "the Los Alamos Historical Museum | the old courthouse | the jail | the University of New Mexico Los Alamos | the Bradbury Science Museum"
Eugene: "the University of Oregon | the old courthouse | the jail | the Jordan Schnitzer Museum of Art | the Hult Center for the Performing Arts"
Coos Bay: "the Coos Art Museum | the old courthouse | the jail | Southwestern Oregon Community College | the Egyptian Theatre"
Bend: "the High Desert Museum | the old courthouse | the jail | Central Oregon Community College | the Tower Theatre"
Cody: "the Buffalo Bill Center of the West | the old courthouse | the jail | Northwest College | the Cody Nite Rodeo"
Cedar Rapids: "the Czech & Slovak Museum & Library | the old courthouse | the jail | Coe College | the Paramount Theatre"
Springfield: "Missouri State University | the old courthouse | the jail | the Discovery Center of Springfield | the Gillioz Theatre"
Lincoln: "the University of Nebraska-Lincoln | the old courthouse | the jail | the Sheldon Museum of Art | the Lied Center for Performing Arts"
Alexandria: "Louisiana State University of Alexandria | the old courthouse | the jail | the Alexandria Museum of Art | the River Oaks Square Arts Center"
Abilene: "Abilene Christian University | the old courthouse | the jail | the National Center for Children's Illustrated Literature | the Paramount Theatre"
Brownsville: "the University of Texas Rio Grande Valley | the old courthouse | the jail | the Historic Brownsville Museum | the Camille Lightner Playhouse"
Tyler: "the University of Texas at Tyler | the old courthouse | the jail | the Tyler Museum of Art | the Liberty Hall"
Concord: "the University of New Hampshire | the old courthouse | the jail | the Capitol Center for the Arts | the New Hampshire Historical Society"
Huntsville: "the University of Alabama in Huntsville | the old courthouse | the jail | the U.S. Space & Rocket Center | the Huntsville Museum of Art"
Key West: "the Ernest Hemingway Home and Museum | the old courthouse | the jail | the Key West Art & Historical Society | the Mallory Square"
West Palm Beach: "the Norton Museum of Art | the old courthouse | the jail | Palm Beach State College | the Kravis Center for the Performing Arts"
Sarasota: "the John and Mable Ringling Museum of Art | the old courthouse | the jail | New College of Florida | the Sarasota Opera House"
Daytona Beach: "the Daytona International Speedway | the old courthouse | the jail | Embry-Riddle Aeronautical University | the Museum of Arts & Sciences"
Gainesville: "the University of Florida | the old courthouse | the jail | the Florida Museum of Natural History | the Hippodrome State Theatre"
Ft. Myers: "Florida Gulf Coast University | the old courthouse | the jail | the Edison and Ford Winter Estates | the Barbara B. Mann Performing Arts Hall"
Brunswick: "the College of Coastal Georgia | the old courthouse | the jail | the Golden Isles Arts & Humanities Association | the Glynn Visual Arts"
Augusta: "Augusta University | the old courthouse | the jail | the Morris Museum of Art | the Augusta Richmond County Civic Center"
Vicksburg: "the Vicksburg National Military Park | the old courthouse | the jail | the Old Court House Museum | the Biedenharn Coca-Cola Museum"
Myrtle Beach: "the SkyWheel | the old courthouse | the jail | Coastal Carolina University | the Carolina Opry"
Charleston: "the College of Charleston | the old courthouse | the jail | the Gibbes Museum of Art | the Charleston Music Hall"
Peoria: "Bradley University | the old courthouse | the jail | the Peoria Riverfront Museum | the Civic Center"
Evansville: "the University of Evansville | the old courthouse | the jail | the Evansville Museum of Arts, History & Science | the Victory Theatre"
Louisville: "the University of Louisville | the old courthouse | the jail | the Speed Art Museum | the Kentucky Center for the Performing Arts"
Lexington: "the University of Kentucky | the old courthouse | the jail | the Lexington Opera House | the Kentucky Theatre"
Charlotte: "the University of North Carolina at Charlotte | the old courthouse | the jail | the Mint Museum | the Blumenthal Performing Arts Center"
Youngstown: "Youngstown State University | the old courthouse | the jail | the Butler Arts Center | the Arms Family Homestead"
Canton: "the Football Hall of Fame | the old courthouse | the old Hoover factory | the Canton Museum of Art | the Palace Theatre"
Toledo: "the University of Toledo | the old courthouse | the jail | the Toledo Museum of Art | the Valentine Theatre"
Columbus: "Ohio State University | the old courthouse | the jail | the Columbus Museum of Art | the Ohio Theatre"
Chattanooga: "the University of Tennessee at Chattanooga | the old courthouse | the jail | the Hunter Museum of American Art | the Tivoli Theatre"
Charlottesville: "the University of Virginia | the old courthouse | the jail | the Virginia Discovery Museum | the Paramount Theater"
Lynchburg: "Liberty University | the old courthouse | the jail | the Lynchburg Museum | the Academy Center of the Arts"
Wausau: "the University of Wisconsin-Marathon County | the old courthouse | the jail | the Leigh Yawkey Woodson Art Museum | the Grand Theater"
Albany: "the University at Albany | the old courthouse | the jail | the New York State Museum | the Palace Theatre"
Ithaca: "Cornell University | the old courthouse | the jail | the Herbert F. Johnson Museum of Art | the State Theatre"
Harrisburg: "the Pennsylvania State University Harrisburg | the old courthouse | the jail | the State Museum of Pennsylvania | the Whitaker Center"
Bangor: "the University of Maine | the old courthouse | the jail | the Bangor Museum and History Center | the Cross Insurance Center"
Portland: "the University of Southern Maine | the old courthouse | the jail | the Portland Museum of Art | the Merrill Auditorium"
Saginaw: "Saginaw Valley State University | the old courthouse | the jail | the Castle Museum | the Temple Theatre"
Ketchikan: "the Tongass Historical Museum | the old courthouse | the jail | the Creek Street historic boardwalk | the Southeast Alaska Discovery Center"
Unalaska: "the Museum of the Aleutians | the old courthouse | the jail | the Holy Ascension Russian Orthodox Cathedral | the Unalaska Community Center"
Togiak: "Central area | the old depot | the homeless shelter | Traditional buildings | Bristol Bay village"
Red Devil: "Central area | the old depot | the homeless shelter | Traditional buildings | Kuskokwim village"
Hooper Bay: "Central area | the old depot | the homeless shelter | Traditional buildings | Yukon Delta village"
Wainwright: "Central area | the old depot | the homeless shelter | Traditional buildings | Arctic coast village"
Galena: "Central area | the old depot | the homeless shelter | Traditional buildings | Yukon village"
Kaktovik: "Central area | the old depot | the homeless shelter | Traditional buildings | Arctic National Wildlife Refuge"
Skagway: "the Klondike Gold Rush National Historical Park | the old courthouse | the jail | the White Pass & Yukon Route Railroad | the Arctic Brotherhood Hall"
Cordova: "the Cordova Historical Museum | the old courthouse | the jail | the Cordova Center | Prince William Sound Community College"
Kenai: "the Kenai Visitors and Cultural Center | the old courthouse | the jail | the Holy Assumption Russian Orthodox Church | Kenai Peninsula College"
Fort Yukon: "Central area | the old depot | the homeless shelter | Traditional buildings | Yukon Flats village"
Brochet: "Central area | the old depot | the homeless shelter | Traditional buildings | Northern Manitoba"
Lynn Lake: "the Lynn Lake Mining Town Museum | the old courthouse | the jail | the Lynn Lake Community Centre | the Northern Manitoba wilderness"
Gillam: "Central area | the old depot | the homeless shelter | Traditional buildings | Hydro town"
North Battleford: "the Allen Sapp Gallery | the old courthouse | the jail | North West Regional College | the Dekker Centre for the Performing Arts"
Prince Albert: "the University of Saskatchewan Prince Albert Campus | the old courthouse | the jail | the Prince Albert Historical Museum | the E.A. Rawlinson Centre"
Courtenay: "the Courtenay Museum | the old courthouse | the jail | North Island College | the Sid Williams Theatre"
Kelowna: "the University of British Columbia Okanagan | the old courthouse | the jail | the Kelowna Art Gallery | Okanagan College"
Pangnirtung: "Central area | the old depot | the homeless shelter | Traditional buildings | Auyuittuq National Park"
Holman: "Central area | the old depot | the homeless shelter | Traditional buildings | Victoria Island"
Dryden: "the Dryden Regional Museum | the old courthouse | the jail | the Dryden Memorial Arena | the Museum of Lake of the Woods"
Attawapiskat: "Central area | the old depot | the homeless shelter | Traditional buildings | James Bay Cree community"
Hamilton: "McMaster University | the old courthouse | the jail | the Art Gallery of Hamilton | the Hamilton Place"
Windsor: "the University of Windsor | the old courthouse | the jail | the Art Gallery of Windsor | the Capitol Theatre"
Trois-Rivières: "the Université du Québec à Trois-Rivières | the old courthouse | the jail | the Musée des arts et traditions populaires | the Cogeco Amphitheatre"
Sept-Îles: "the Cégep de Sept-Îles | the old courthouse | the jail | the Musée régional de la Côte-Nord | the Complexe sportif Légion"
Corner Brook: "the Memorial University Grenfell Campus | the old courthouse | the jail | the Corner Brook Museum & Archives | the Arts and Culture Centre"
Cabo San Lucas: "the Arch of Cabo San Lucas | the old courthouse | Central Plaza | the old depot | Marina area"
Monclova: "Central Plaza | the old depot | Town hall | Market area | Steel industry center"
Ometepec: "Central Plaza | the old depot | Town hall | Market area | Indigenous cultural center"
Cozumel: "the Mayan ruins of San Gervasio | the old courthouse | Central Plaza | the old depot | Diving destination"
San Juan: "the El Yunque National Forest | the old courthouse | the jail | the University of Puerto Rico | Fort San Felipe del Morro"
Norway House: "Central area | the old depot | the homeless shelter | Traditional buildings | Cree Nation"
Flin Flon: "the Flin Flon Museum | the old courthouse | the jail | the Flin Flon Community Choir | the Northern Manitoba wilderness"
Dauphin: "the Fort Dauphin Museum | the old courthouse | the jail | the Assiniboine Community College | the Canada's National Ukrainian Festival grounds"
The Pas: "the University College of the North | the old courthouse | the jail | the Sam Waller Museum | the The Pas Indian Band"
Uranium City: "Central area | the old depot | the homeless shelter | Traditional buildings | Former uranium mining town"
Moose Jaw: "the Tunnels of Moose Jaw | the old courthouse | the jail | the Western Development Museum | the Moose Jaw Cultural Centre"
Jasper: "Jasper National Park | the old courthouse | the jail | the Jasper-Yellowhead Museum | the Fairmont Jasper Park Lodge"
Medicine Hat: "Medicine Hat College | the old courthouse | the jail | the Esplanade Arts & Heritage Centre | the Saamis Archaeological Site"
Red Deer: "Red Deer College | the old courthouse | the jail | the Red Deer Museum + Art Gallery | the Red Deer Memorial Centre"
Banff: "Banff National Park | the old courthouse | the jail | the Banff Centre for Arts and Creativity | the Whyte Museum"
Grand Prairie: "Grande Prairie Regional College | the old courthouse | the jail | the Philip J. Currie Dinosaur Museum | the Eastlink Centre"
Smithers: "the Bulkley Valley Museum | the old courthouse | the jail | the College of New Caledonia | the the jail Building"
Kamloops: "Thompson Rivers University | the old courthouse | the jail | the Kamloops Museum and Archives | the Sandman Centre"
Williams Lake: "Thompson Rivers University Williams Lake Campus | the old courthouse | the jail | the Museum of the Cariboo Chilcotin | the Cariboo Memorial Recreation Complex"
Prince George: "the University of Northern British Columbia | the old courthouse | the jail | the Prince George Railway Museum | the CN Centre"
Fort Nelson: "the Fort Nelson Heritage Museum | the old courthouse | the jail | Northern Lights College | the Fort Nelson Recreation Centre"
Pond Inlet: "Central area | the old depot | the homeless shelter | Traditional buildings | Sirmilik National Park"
Cape Dorset: "the West Baffin Eskimo Co-operative | Central area | the old depot | the homeless shelter | Inuit art capital"
Kimmirut: "Central area | the old depot | the homeless shelter | Traditional buildings | Auyuittuq National Park area"
Gjoa Haven: "Central area | the old depot | the homeless shelter | Traditional buildings | Northwest Passage historic site"
Grise Fiord: "Central area | the old depot | the homeless shelter | Traditional buildings | Northernmost community"
Alert: "Central area | Military base | Weather station | Research facilities | Northernmost settlement"
Ennadai: "Central area | the old depot | the homeless shelter | Traditional buildings | Barren Lands"
Rankin Inlet: "the Iqalugaarjuup Nunanga Territorial Park | Central area | the old depot | the homeless shelter | Nunavut Learning Centre"
Fort Resolution: "Central area | the old depot | the homeless shelter | Traditional buildings | Great Slave Lake area"
Fort Simpson: "the Fort Simpson Historical Society Museum | the old courthouse | the jail | the Open Sky Festival grounds | the Deh Cho Friendship Centre"
Inuvik: "the Igloo Church | the old courthouse | the jail | Aurora College | the Midnight Sun Recreation Complex"
Tuktoyaktuk: "Central area | the old depot | the homeless shelter | Traditional buildings | Arctic Ocean coast"
Watson Lake: "the Watson Lake Sign Post Forest | the old courthouse | the jail | the Northern Lights Centre | Yukon College"
Lansdowne House: "Central area | the old depot | the homeless shelter | Traditional buildings | Remote First Nations community"
Moosonee: "the Moosonee Museum | the old courthouse | the jail | the Polar Bear Express terminus | Northern College"
Sudbury: "Laurentian University | the old courthouse | the jail | Science North | the Sudbury Theatre Centre"
Kenora: "the Lake of the Woods Museum | the old courthouse | the jail | the Kenora Recreation Centre | Confederation College"
Gaspe: "the Gaspésie National Park | the old courthouse | the jail | the Cégep de la Gaspésie | the Musée de la Gaspésie"
Mingan: "Central area | the old depot | the homeless shelter | Traditional buildings | Mingan Archipelago National Park Reserve"
Dolbeau: "the Cégep de Saint-Félicien campus | the old courthouse | the jail | the Centre culturel et communautaire | the Complexe sportif"
Val d'Or: "the Université du Québec en Abitibi-Témiscamingue | the old courthouse | the jail | the Musée minéralogique de l'Abitibi-Témiscamingue | the Centre culturel"
Ivugivik: "Central area | the old depot | the homeless shelter | Traditional buildings | Nunavik village"
Inukjuak: "Central area | the old depot | the homeless shelter | Traditional buildings | Hudson Bay coast"
Chicoutimi: "the Université du Québec à Chicoutimi | the old courthouse | the jail | the Musée du Saguenay | the Centre des arts et de spectacles"
Moncton: "the Université de Moncton | the old courthouse | the jail | the Resurgo Place | the Capitol Theatre"
Fredericton: "the University of New Brunswick | the old courthouse | the jail | the Beaverbrook Art Gallery | the Playhouse"
Bathurst: "the Université de Moncton Shippagan Campus | the old courthouse | the jail | the Daly Point Nature Reserve | the KC Irving Regional Centre"
Yarmouth: "the Yarmouth County Museum | the old courthouse | the jail | the Mariners Centre | the Aspen Grove Hiking Trail"
Gander: "the North Atlantic Aviation Museum | the old courthouse | the jail | the College of the North Atlantic | the Steele Community Centre"
Cartwright: "Central area | the old depot | the homeless shelter | Traditional buildings | Labrador coast"
Rigolet: "Central area | the old depot | the homeless shelter | Traditional buildings | Nunatsiavut government"
Port Burwell: "Central area | the old depot | the homeless shelter | Traditional buildings | Nunatsiavut region"
Arecibo: "the Arecibo Observatory | the old courthouse | the jail | the Inter American University | the Casa Blanca Museum"
Santa Cruz: "the University of California Santa Cruz | the old courthouse | the jail | the Santa Cruz Beach Boardwalk | the Santa Cruz Museum of Art & History"
San Bernardino: "California State University San Bernardino | the old courthouse | the jail | the San Bernardino County Museum | the California Theatre"
Bridgeport: "the University of Bridgeport | the old courthouse | the jail | the Barnum Museum | the Klein Memorial Auditorium"
Rochester: "the University of Rochester | the old courthouse | the jail | the Strong National Museum of Play | the Eastman Theatre"
International Falls: "the Koochiching County Historical Museum | the old courthouse | the jail | Rainy River Community College | the Backus Community Center"
St. Paul: "the University of St. Thomas | the old courthouse | the jail | the Science Museum of Minnesota | the Ordway Center for the Performing Arts"
Billings: "Montana State University Billings | the old courthouse | the jail | the Yellowstone Art Museum | the Alberta Bair Theater"
Great Falls: "the University of Great Falls | the old courthouse | the jail | the C.M. Russell Museum | the Mansfield Center for Performing Arts"
Missoula: "the University of Montana | the old courthouse | the jail | the Missoula Art Museum | the Wilma Theatre"
Minot: "Minot State University | the old courthouse | the jail | the Taube Museum of Art | the North Dakota State Fair Center"
Fargo: "North Dakota State University | the old courthouse | the jail | the Plains Art Museum | the Fargo Theatre"
Hilo: "the University of Hawaii at Hilo | the old courthouse | the jail | the Lyman Museum | the Palace Theater"
Olympia: "The Evergreen State College | the old courthouse | the jail | the Washington State Capitol | the Washington Center for the Performing Arts"
Spokane: "Gonzaga University | the old courthouse | the jail | the Northwest Museum of Arts & Culture | the Fox Theater"
Vancouver: "Washington State University Vancouver | the old courthouse | the jail | the Clark County Historical Museum | the Kiggins Theatre"
Flagstaff: "Northern Arizona University | the old courthouse | the jail | the Museum of Northern Arizona | the Orpheum Theater"
Tucson: "the University of Arizona | the old courthouse | the jail | the Arizona State Museum | the Fox Tucson Theatre"
Santa Barbara: "the University of California Santa Barbara | the old courthouse | the jail | the Santa Barbara Museum of Art | the Granada Theatre"
Fresno: "California State University Fresno | the old courthouse | the jail | the Fresno Art Museum | the Saroyan Theatre"
Eureka: "Humboldt State University | the old courthouse | the jail | the Clarke Historical Museum | the Arkley Center for the Performing Arts"
Colorado Springs: "the University of Colorado Colorado Springs | the old courthouse | the jail | the Colorado Springs Fine Arts Center | the Pikes Peak Center"
Reno: "the University of Nevada Reno | the old courthouse | the jail | the Nevada Museum of Art | the Pioneer Center for the Performing Arts"
Elko: "the Nevada Northern Railway Museum | the old courthouse | the jail | Great Basin College | the Western Folklife Center"
Albuquerque: "the University of New Mexico | the old courthouse | the jail | the Albuquerque Museum | the KiMo Theatre"
Salem: "Willamette University | the old courthouse | the jail | the Hallie Ford Museum of Art | the Elsinore Theatre"
Casper: "the University of Wyoming at Casper | the old courthouse | the jail | the Nicolaysen Art Museum | the Casper Events Center"
Topeka: "Washburn University | the old courthouse | the jail | the Kansas Museum of History | the Topeka Performing Arts Center"
Kansas City: "the University of Kansas Medical Center | the old courthouse | the jail | the Nelson-Atkins Museum of Art | the Kauffman Center for the Performing Arts"
Tulsa: "the University of Tulsa | the old courthouse | the jail | the Philbrook Museum of Art | the BOK Center"
Sioux Falls: "the University of Sioux Falls | the old courthouse | the jail | the Washington Pavilion | the Orpheum Theater Center"
Shreveport: "Louisiana State University Shreveport | the old courthouse | the jail | the R.W. Norton Art Gallery | the Shreveport Municipal Auditorium"
Baton Rouge: "Louisiana State University | the old courthouse | the jail | the Louisiana Art & Science Museum | the Shaw Center for the Arts"
Ft. Worth: "Texas Christian University | the old courthouse | the jail | the Kimbell Art Museum | the Bass Performance Hall"
Corpus Christi: "Texas A&M University-Corpus Christi | the old courthouse | the jail | the Art Museum of South Texas | the Harbor Playhouse"
Austin: "the University of Texas at Austin | the old courthouse | the jail | the Blanton Museum of Art | the Paramount Theatre"
Amarillo: "West Texas A&M University | the old courthouse | the jail | the Amarillo Museum of Art | the Globe-News Center"
El Paso: "the University of Texas at El Paso | the old courthouse | the jail | the El Paso Museum of Art | the Plaza Theatre"
Laredo: "Texas A&M International University | the old courthouse | the jail | the Republic of the Rio Grande Museum | the Laredo Center for the Arts"
Burlington: "the University of Vermont | the old courthouse | the jail | the Fleming Museum of Art | the Flynn Center for the Performing Arts"
Montgomery: "Auburn University at Montgomery | the old courthouse | the jail | the Montgomery Museum of Fine Arts | the Alabama Shakespeare Festival"
Tallahassee: "Florida State University | the old courthouse | the jail | the Museum of Fine Arts | the Ruby Diamond Concert Hall"
Orlando: "the University of Central Florida | the old courthouse | the jail | the Orlando Museum of Art | the Dr. Phillips Center for the Performing Arts"
Jacksonville: "the University of North Florida | the old courthouse | the jail | the Cummer Museum of Art & Gardens | the Florida Theatre"
Savannah: "the Savannah College of Art and Design | the old courthouse | the jail | the Telfair Museums | the Savannah Theatre"
Columbia: "the University of South Carolina | the old courthouse | the jail | the Columbia Museum of Art | the Koger Center for the Arts"
Indianapolis: "Indiana University-Purdue University Indianapolis | the old courthouse | the jail | the Indianapolis Museum of Art | the Indiana Repertory Theatre"
Wilmington: "the University of North Carolina Wilmington | the old courthouse | the jail | the Cameron Art Museum | the Thalian Hall Center for the Performing Arts"
Knoxville: "the University of Tennessee | the old courthouse | the jail | the Knoxville Museum of Art | the Tennessee Theatre"
Richmond: "Virginia Commonwealth University | the old courthouse | the jail | the Virginia Museum of Fine Arts | the Carpenter Theatre"
Charleston: "the University of Charleston | the old courthouse | the jail | the Clay Center for the Arts & Sciences | the Municipal Auditorium"
Baltimore: "Johns Hopkins University | the old courthouse | the jail | the Walters Art Museum | the Meyerhoff Symphony Hall"
Syracuse: "Syracuse University | the old courthouse | the jail | the Everson Museum of Art | the Oncenter Crouse Hinds Theater"
Port-of-Spain: "the University of the West Indies | the old courthouse | the jail | the National Museum and Art Gallery | the Queen's Hall"
Augusta: "the University of Maine at Augusta | the old courthouse | the jail | the Maine State Museum | the Waterville Opera House"
Sault Ste. Marie: "Lake Superior State University | the old courthouse | the jail | the River of History Museum | the Kewadin Casino"
Sitka: "the University of Alaska Southeast Sitka Campus | the old courthouse | the jail | the Sitka National Historical Park | the Harrigan Centennial Hall"
Cottica: "Central square | the old depot | Town hall | Market area | Interior region"
Mexicali: "the Autonomous University of Baja California | the old courthouse | Central Plaza | the State Center for the Arts | the Regional Museum"
La Paz: "the Autonomous University of Baja California Sur | the old courthouse | Central Plaza | the Regional Museum of Anthropology | the Carlos Amador Theatre"
Torreon: "the Autonomous University of Coahuila | the old courthouse | Central Plaza | the Arocena Museum | the Nazas Theatre"
Culiacan: "the Autonomous University of Sinaloa | the old courthouse | Central Plaza | the Sinaloa Art Museum | the Pablo de Villavicencio Theatre"
Nogales: "Central Plaza | the old depot | Town hall | Market area | Border city"
Hermosillo: "the University of Sonora | the old courthouse | Central Plaza | the Sonora Museum | the Dr. Alvaro Obregón Cultural Centre"
Guaymas: "Central Plaza | the old depot | Town hall | Market area | Port city"
San Luis Potosi: "the Autonomous University of San Luis Potosí | the old courthouse | Central Plaza | the National Museum of the Mask | the Tangamanga Cultural Centre"
Matamoros: "the Autonomous University of Tamaulipas | the old courthouse | Central Plaza | the Casa Mata Museum | the Olimpico Theatre"
Nuevo Laredo: "Central Plaza | the old depot | Town hall | Market area | Border city"
Colima: "the University of Colima | the old courthouse | Central Plaza | the Regional History Museum | the Hidalgo Theatre"
Campeche: "the Autonomous University of Campeche | the old courthouse | Central Plaza | the Campeche Museum | UNESCO World Heritage site"
Oaxaca: "the Autonomous University of Benito Juárez of Oaxaca | the old courthouse | Central Plaza | the Rufino Tamayo Museum | UNESCO World Heritage site"
Leon: "the University of Guanajuato | the old courthouse | Central Plaza | the Leon Museum | the Bicentennial Theatre"
Santiago de Cuba: "the University of Santiago de Cuba | the old courthouse | the jail | the Antonio Maceo Museum | the Dolores Concert Hall"
Santiago: "the University of Santiago de Cuba | the old courthouse | the jail | the Frank País Museum | the José María Heredia Theatre"
Thompson: "the University College of the North | the old courthouse | the jail | the Heritage North Museum | the R.D. Parker Collegiate"
Brandon: "Brandon University | the old courthouse | the jail | the Art Gallery of Southwestern Manitoba | the Western Manitoba Centennial Auditorium"
Fort Smith: "Aurora College | the old courthouse | the jail | the Northern Life Museum | the Thebacha Campus"
Fort McMurray: "Keyano College | the old courthouse | the jail | the Oil Sands Discovery Centre | the Suncor Community Leisure Centre"
Peace River: "Grande Prairie Regional College Peace River Campus | the old courthouse | the jail | the Peace River Museum | the Baytex Energy Centre"
Fort St. John: "Northern Lights College | the old courthouse | the jail | the North Peace Museum | the Pomeroy Sport Centre"
Iqaluit: "the University of Prince Edward Island Nunavut Campus | the old courthouse | the jail | the Nunatta Sunakkutaangit Museum | the Astro Hill Complex"
Cambridge Bay: "Central area | the old depot | the homeless shelter | Traditional buildings | Northwest Passage hub"
Kugluktuk: "Central area | the old depot | the homeless shelter | Traditional buildings | Coppermine area"
Chesterfield Inlet: "Central area | the old depot | the homeless shelter | Traditional buildings | Baker Lake region"
Arviat: "Central area | the old depot | the homeless shelter | Traditional buildings | Hudson Bay coast"
Taloyoak: "Central area | the old depot | the homeless shelter | Traditional buildings | Boothia Peninsula"
Igloolik: "Central area | the old depot | the homeless shelter | Traditional buildings | Foxe Basin"
Dawson City: "the Dawson City Museum | the old courthouse | the jail | Yukon College | the Palace Grand Theatre"
Timmins: "the Timmins Museum | the old courthouse | the jail | Northern College | the McIntyre Arena"
North Bay: "Nipissing University | the old courthouse | the jail | the North Bay Museum | the Capitol Centre"
Kuujjuarapik: "Central area | the old depot | the homeless shelter | Traditional buildings | Hudson Bay coast"
Kuujjuaq: "Central area | the old depot | the homeless shelter | Traditional buildings | Nunavik administrative center"
Sydney: "Cape Breton University | the old courthouse | the jail | the Joan Harriss Cruise Pavilion | the Centre 200"
Labrador City: "the College of the North Atlantic | the old courthouse | the jail | the Labrador City Arena | the Gateway Plaza"
Bridgetown: "the University of the West Indies Cave Hill Campus | the old courthouse | the jail | the Queen's Park | the Frank Collymore Hall"
Kingstown: "the University of the West Indies Open Campus | the old courthouse | the jail | the Botanic Gardens | the Peace Memorial Hall"
Castries: "the University of the West Indies Open Campus | the old courthouse | the jail | the Derek Walcott Square | the Cultural Centre"
Basseterre: "the University of the West Indies Open Campus | the old courthouse | the jail | the Independence Square | the Warner Park"
Saint George's: "St. George's University | the old courthouse | the jail | the Grenada National Museum | the Marryshow Folk Theatre"
Helena: "Carroll College | the old courthouse | the jail | the Montana Historical Society Museum | the Myrna Loy Center"
Bismarck: "the University of Mary | the old courthouse | the jail | the North Dakota Heritage Center | the Belle Mehus Auditorium"
Boise: "Boise State University | the old courthouse | the jail | the Boise Art Museum | the Morrison Center for the Performing Arts"
San Jose: "San Jose State University | the old courthouse | the jail | the San Jose Museum of Art | the California Theatre"
Sacramento: "California State University Sacramento | the old courthouse | the jail | the Crocker Art Museum | the Community Center Theatre"
Las Vegas: "the University of Nevada Las Vegas | the old courthouse | the jail | the Neon Museum | the Smith Center for the Performing Arts"
Santa Fe: "the College of Santa Fe | the old courthouse | the jail | the Georgia O'Keeffe Museum | the Santa Fe Opera"
Portland: "Portland State University | the old courthouse | the jail | the Portland Art Museum | the Keller Auditorium"
Salt Lake City: "the University of Utah | the old courthouse | the jail | the Utah Museum of Fine Arts | the Eccles Theater"
Cheyenne: "the University of Wyoming Outreach School | the old courthouse | the jail | the Cheyenne Frontier Days Old West Museum | the Cheyenne Civic Center"
Des Moines: "Drake University | the old courthouse | the jail | the Des Moines Art Center | the Civic Center of Greater Des Moines"
Omaha: "the University of Nebraska at Omaha | the old courthouse | the jail | the Joslyn Art Museum | the Orpheum Theater"
Oklahoma City: "the University of Oklahoma Health Sciences Center | the old courthouse | the jail | the Oklahoma City Museum of Art | the Civic Center Music Hall"
Pierre: "the University of South Dakota Pierre | the old courthouse | the jail | the South Dakota Discovery Center | the Riggs Theatre"
San Antonio: "the University of Texas at San Antonio | the old courthouse | the jail | the San Antonio Museum of Art | the Majestic Theatre"
Jackson: "Jackson State University | the old courthouse | the jail | the Mississippi Museum of Art | the Thalia Mara Hall"
Raleigh: "North Carolina State University | the old courthouse | the jail | the North Carolina Museum of Art | the Red Hat Amphitheater"
Cleveland: "Case Western Reserve University | the old courthouse | the jail | the Cleveland Museum of Art | the Playhouse Square"
Cincinnati: "the University of Cincinnati | the old courthouse | the jail | the Cincinnati Art Museum | the Music Hall"
Nashville: "Vanderbilt University | the old courthouse | the jail | the Country Music Hall of Fame | the Ryman Auditorium"
Memphis: "the University of Memphis | the old courthouse | the jail | the National Civil Rights Museum | the Orpheum Theatre"
Norfolk: "Old Dominion University | the old courthouse | the jail | the Chrysler Museum of Art | the Norfolk Scope"
Milwaukee: "the University of Wisconsin-Milwaukee | the old courthouse | the jail | the Milwaukee Art Museum | the Marcus Center for the Performing Arts"
Buffalo: "the University at Buffalo | the old courthouse | the jail | the Albright-Knox Art Gallery | the Shea's Performing Arts Center"
Pittsburgh: "the University of Pittsburgh | the old courthouse | the jail | the Carnegie Museums | the Heinz Hall"
Kodiak: "the University of Alaska Anchorage Kodiak Campus | the old courthouse | the jail | the Kodiak History Museum | the Kodiak Arts Council"
Cold Bay: "Central area | the old depot | the homeless shelter | Traditional buildings | Aleutian Peninsula"
Bethel: "the University of Alaska Fairbanks Kuskokwim Campus | the old courthouse | the jail | the Yupiit Piciryarait Cultural Center | the Bethel Community Center"
Point Hope: "Central area | the old depot | the homeless shelter | Traditional buildings | Northernmost Inupiat village"
Barrow: "Ilisagvik College | the old courthouse | the jail | the Inupiat Heritage Center | the Barrow Arctic Science Consortium"
Nome: "the University of Alaska Fairbanks Northwest Campus | the old courthouse | the jail | the Carrie M. McLain Memorial Museum | the Nome Community Center"
Valdez: "the Valdez Museum | the old courthouse | the jail | Prince William Sound Community College | the Valdez Convention & Civic Center"
Juneau: "the University of Alaska Southeast | the old courthouse | the jail | the Alaska State Museum | the Perseverance Theatre"
Fairbanks: "the University of Alaska Fairbanks | the old courthouse | the jail | the Museum of the North | the Carlson Center"
Prudhoe Bay: "Central area | Industrial facilities | Research stations | Oil industry infrastructure | Arctic research"
Port-au-Prince: "the University of Haiti | the old courthouse | the jail | the National Museum of Haiti | the Rex Theatre"
Paramaribo: "the University of Suriname | the old courthouse | the jail | the Suriname Museum | UNESCO World Heritage site"
Tijuana: "the Autonomous University of Baja California | the old courthouse | Central Plaza | the Cultural Center | the Tijuana Country Club"
Chihuahua: "the Autonomous University of Chihuahua | the old courthouse | Central Plaza | the Museum of the Revolution | the Government Palace"
Mazatlan: "the Autonomous University of Sinaloa | the old courthouse | Central Plaza | the Angela Peralta Theatre | the Historic Center"
Tampico: "the Autonomous University of Tamaulipas | the old courthouse | Central Plaza | the Metropolitan Museum | the Tampico Cultural Center"
Acapulco: "the Autonomous University of Guerrero | the old courthouse | Central Plaza | Fort San Diego | the Acapulco Convention Center"
Veracruz: "the University of Veracruz | the old courthouse | Central Plaza | the San Juan de Ulúa fortress | the Agustín Lara House Museum"
Tuxtla Gutierrez: "the University of Sciences and Arts of Chiapas | the old courthouse | Central Plaza | the Regional Museum of Chiapas | the Teatro de la Ciudad"
Cancun: "the University of the Caribbean | the old courthouse | Central Plaza | the Maya Museum | the Cancun Convention Center"
Merida: "the Autonomous University of Yucatan | the old courthouse | Central Plaza | the Gran Museo del Mundo Maya | the José Peón Contreras Theatre"
Kingston: "the University of the West Indies | the old courthouse | Central Square | the Bob Marley Museum | the Ward Theatre"
Winnipeg: "the University of Manitoba | the old courthouse | the jail | the Winnipeg Art Gallery | the Centennial Concert Hall"
Churchill: "the Churchill Northern Studies Centre | the old courthouse | the jail | the Eskimo Museum | the Parks Canada Visitor Reception Centre"
Regina: "the University of Regina | the old courthouse | the jail | the MacKenzie Art Gallery | the Conexus Arts Centre"
Saskatoon: "the University of Saskatchewan | the old courthouse | the jail | the Mendel Art Gallery | the TCU Place"
Calgary: "the University of Calgary | the old courthouse | the jail | the Glenbow Museum | the Southern Alberta Jubilee Auditorium"
Prince Rupert: "the Museum of Northern British Columbia | the old courthouse | the jail | Northwest Community College | the Lester Centre of the Arts"
Victoria: "the University of Victoria | the old courthouse | the jail | the Royal BC Museum | the Royal Theatre"
Arctic Bay: "Central area | the old depot | the homeless shelter | Traditional buildings | Eclipse Sound"
Resolute: "Central area | the old depot | the homeless shelter | Traditional buildings | High Arctic research"
Repulse Bay: "Central area | the old depot | the homeless shelter | Traditional buildings | Naujaat community"
Yellowknife: "Aurora College | the old courthouse | the jail | the Prince of Wales Northern Heritage Centre | the Northern Arts and Cultural Centre"
Fort Good Hope: "Central area | the old depot | the homeless shelter | Traditional buildings | Mackenzie River community"
Whitehorse: "Yukon College | the old courthouse | the jail | the MacBride Museum | the Yukon Arts Centre"
Ottawa: "the University of Ottawa | the old courthouse | the jail | the National Gallery of Canada | the National Arts Centre"
Fort Severn: "Central area | the old depot | the homeless shelter | Traditional buildings | Hudson Bay lowlands"
Thunder Bay: "Lakehead University | the old courthouse | the jail | the Thunder Bay Art Gallery | the Thunder Bay Community Auditorium"
Québec: "Université Laval | the old courthouse | the jail | the Musée national des beaux-arts du Québec | the Grand Théâtre de Québec"
Halifax: "Dalhousie University | the old courthouse | the jail | the Art Gallery of Nova Scotia | the Rebecca Cohn Auditorium"
St. Johns: "Memorial University of Newfoundland | the old courthouse | the jail | the Rooms | the Arts and Culture Centre"
Nain: "Central area | the old depot | the homeless shelter | Traditional buildings | Nunatsiavut capital"
Charlottetown: "the University of Prince Edward Island | the old courthouse | the jail | the Confederation Centre of the Arts | the Charlottetown Festival"
San Juan: "the University of Puerto Rico | the old courthouse | the jail | the Museo de Arte de Puerto Rico | the Luis A. Ferré Performing Arts Center"
Hamilton: "the Bermuda College | the old courthouse | the jail | the Bermuda National Gallery | the City Hall Theatre"
Minneapolis: "the University of Minnesota | the old courthouse | the jail | the Walker Art Center | the Guthrie Theater"
Honolulu: "the University of Hawaii at Manoa | the old courthouse | the jail | the Honolulu Museum of Art | the Neal S. Blaisdell Center"
Seattle: "the University of Washington | the old courthouse | the jail | the Seattle Art Museum | the Benaroya Hall"
Phoenix: "Arizona State University | the old courthouse | the jail | the Phoenix Art Museum | the Orpheum Theatre"
San Diego: "the University of California San Diego | the old courthouse | the jail | the San Diego Museum of Art | the Civic Theatre"
St. Louis: "Washington University in St. Louis | the old courthouse | the jail | the Saint Louis Art Museum | the Powell Symphony Hall"
New Orleans: "Tulane University | the old courthouse | the jail | the New Orleans Museum of Art | the Saenger Theatre"
Dallas: "Southern Methodist University | the old courthouse | the jail | the Dallas Museum of Art | the Winspear Opera House"
Boston: "Harvard University | the old courthouse | the jail | the Museum of Fine Arts | the Boston Symphony Hall"
Tampa: "the University of South Florida | the old courthouse | the jail | the Tampa Museum of Art | the Straz Center for the Performing Arts"
Philadelphia: "the University of Pennsylvania | the old courthouse | the jail | the Philadelphia Museum of Art | the Kimmel Center"
Detroit: "Wayne State University | the old courthouse | the jail | the Detroit Institute of Arts | the Fox Theatre"
Anchorage: "the University of Alaska Anchorage | the old courthouse | the jail | the Anchorage Museum | the Alaska Center for the Performing Arts"
Guadalajara: "the University of Guadalajara | the old courthouse | Central Plaza | the Hospicio Cabañas | the Degollado Theatre"
Puebla: "the Autonomous University of Puebla | the old courthouse | Central Plaza | the Puebla Cathedral | UNESCO World Heritage site"
Havana: "the University of Havana | the old courthouse | the jail | the Museum of the Revolution | the Great Theatre of Havana"
Santo Domingo: "the Autonomous University of Santo Domingo | the old courthouse | the jail | the Alcázar de Colón | UNESCO World Heritage site"
Edmonton: "the University of Alberta | the old courthouse | the jail | the Art Gallery of Alberta | the Winspear Centre"
Montréal: "McGill University | the old courthouse | the jail | the Montreal Museum of Fine Arts | Place des Arts"
San Francisco: "the University of California San Francisco | the old courthouse | the jail | the San Francisco Museum of Modern Art | the War Memorial Opera House"
Denver: "the University of Colorado Denver | the old courthouse | the jail | the Denver Art Museum | the Denver Center for the Performing Arts"
Houston: "Rice University | the old courthouse | the jail | the Museum of Fine Arts Houston | the Wortham Theater Center"
Miami: "the University of Miami | the old courthouse | the jail | the Pérez Art Museum Miami | the Adrienne Arsht Center"
Atlanta: "Emory University | the old courthouse | the jail | the High Museum of Art | the Fox Theatre"
Chicago: "the University of Chicago | the old courthouse | the jail | the Art Institute of Chicago | the Chicago Symphony Center"
Monterrey: "the Autonomous University of Nuevo León | the old courthouse | Central Plaza | the Museum of Contemporary Art | the Macroplaza"
Vancouver: "the University of British Columbia | the old courthouse | the jail | the Vancouver Art Gallery | the Queen Elizabeth Theatre"
Toronto: "the University of Toronto | the old courthouse | the jail | the Art Gallery of Ontario | the Four Seasons Centre"
Los Angeles: "the University of California Los Angeles | the old courthouse | the jail | the Los Angeles County Museum of Art | the Walt Disney Concert Hall"
Washington: "George Washington University | the old courthouse | the jail | the Smithsonian Institution | the Kennedy Center"
New York: "Columbia University | the old courthouse | the jail | the Metropolitan Museum of Art | Lincoln Center"
Mexico City: "the National Autonomous University of Mexico | the old courthouse | Central Plaza | the National Museum of Anthropology | the Palace of Fine Arts"